"Dato";"Valør";"Tekst";"";"Beløb";"Saldo";"Egen bilagsreference"
"02.01.2024";"02.01.2024";"Nets 0032 8822884                   -SE MEDD.";"";"1.217,42";"160.379,91";""
"02.01.2024";"02.01.2024";"Til EJENDOMS. CAROMAT";"";"-35.420,33";"124.959,58";""
"02.01.2024";"02.01.2024";"Henri Lee- inco";"";"-1.410,09";"123.549,49";""
"02.01.2024";"02.01.2024";"DK  3257668 108645108550 29.12";"";"4.931,00";"128.480,49";""
"02.01.2024";"02.01.2024";"DK  3257668 336320800000 29.12";"";"338,00";"128.818,49";""
"02.01.2024";"02.01.2024";"LS 46868 THAI FRESH IMPORT/EKSPORT";"";"-5.163,13";"123.655,36";""
"02.01.2024";"02.01.2024";"DK  3257668 108645108750 30.12";"";"2.963,00";"126.618,36";""
"02.01.2024";"02.01.2024";"DK  3257668 336420800000 30.12";"";"2.000,00";"128.618,36";""
"03.01.2024";"03.01.2024";"Overførsel                          -SE MEDD.";"";"10.325,25";"138.943,61";""
"03.01.2024";"03.01.2024";"Nets 0032 8822884                   -SE MEDD.";"";"1.727,82";"140.671,43";""
"03.01.2024";"03.01.2024";"Nets 0033 8822884                   -SE MEDD.";"";"6.830,84";"147.502,27";""
"03.01.2024";"03.01.2024";"PBS DK Abon 3257668 011223-311223";"";"-422,31";"147.079,96";""
"03.01.2024";"03.01.2024";"DK  3257668 108645109150 02.01";"";"3.000,50";"150.080,46";""
"03.01.2024";"03.01.2024";"Henri Lee-udlæg (Inco & gas)";"";"-3.500,00";"146.580,46";""
"04.01.2024";"04.01.2024";"Til DAKA DENMARK A/S";"";"-240,66";"146.339,80";""
"04.01.2024";"04.01.2024";"Mealo: 16086                        -SE MEDD.";"";"38.805,53";"185.145,33";""
"04.01.2024";"04.01.2024";"Nets 0034 8822884                   -SE MEDD.";"";"4.769,24";"189.914,57";""
"04.01.2024";"04.01.2024";"DK  3257668 108645109350 03.01";"";"633,00";"190.547,57";""
"05.01.2024";"05.01.2024";"Nets 0035 8822884                   -SE MEDD.";"";"3.471,53";"194.019,10";""
"05.01.2024";"05.01.2024";"DK  3257668 108645109550 04.01";"";"1.935,00";"195.954,10";""
"05.01.2024";"05.01.2024";"LS 46868 THAI FRESH IMPORT/EKSPORT";"";"-4.413,75";"191.540,35";""
"05.01.2024";"05.01.2024";"Hgl- silvan, hjem&fix, flügger";"";"-4.393,95";"187.146,40";""
"05.01.2024";"05.01.2024";"Henri Lee- udlæg";"";"-1.000,00";"186.146,40";""
"05.01.2024";"05.01.2024";"Til SJ.MEDIER ANN.";"";"-1.200,00";"184.946,40";""
"05.01.2024";"05.01.2024";"Til SJ.MEDIER ANN.";"";"-525,00";"184.421,40";""
"08.01.2024";"08.01.2024";"Mealo: 16238                        -SE MEDD.";"";"8.110,60";"192.532,00";""
"08.01.2024";"08.01.2024";"DK  3257668 108645109750 05.01";"";"3.479,00";"196.011,00";""
"08.01.2024";"08.01.2024";"DK  3257668 400520800000 05.01";"";"779,00";"196.790,00";""
"08.01.2024";"08.01.2024";"LS 46868 THAI FRESH IMPORT/EKSPORT";"";"-4.487,50";"192.302,50";""
"08.01.2024";"08.01.2024";"DK  3257668 108645109950 06.01";"";"1.751,00";"194.053,50";""
"08.01.2024";"08.01.2024";"DK  3257668 108645110150 07.01";"";"1.208,00";"195.261,50";""
"08.01.2024";"08.01.2024";"DK  3257668 400620800000 06.01";"";"2.758,00";"198.019,50";""
"09.01.2024";"09.01.2024";"Nets 0036 8822884                   -SE MEDD.";"";"3.260,02";"201.279,52";""
"09.01.2024";"09.01.2024";"Nets 0037 8822884                   -SE MEDD.";"";"3.705,88";"204.985,40";""
"09.01.2024";"09.01.2024";"Fakt. 45                            -SE MEDD.";"";"7.007,81";"211.993,21";""
"09.01.2024";"09.01.2024";"Overførsel                          -SE MEDD.";"";"10.548,95";"222.542,16";""
"10.01.2024";"10.01.2024";"LS 21865 CARLSBERG DANMARK A/S";"";"-5.701,40";"216.840,76";""
"10.01.2024";"10.01.2024";"DK  3257668 108645110450 09.01";"";"2.863,00";"219.703,76";""
"11.01.2024";"11.01.2024";"DK  3257668 108645110650 10.01";"";"3.417,00";"223.120,76";""
"11.01.2024";"11.01.2024";"LS 46868 THAI FRESH IMPORT/EKSPORT";"";"-4.433,88";"218.686,88";""
"11.01.2024";"11.01.2024";"Nets 0038 8822884                   -SE MEDD.";"";"5.043,34";"223.730,22";""
"11.01.2024";"11.01.2024";"Nets 0039 8822884                   -SE MEDD.";"";"1.733,78";"225.464,00";""
"11.01.2024";"11.01.2024";"Til Remondis";"";"-2.615,60";"222.848,40";""
"11.01.2024";"11.01.2024";"Wolt Drive INVWAWDNK1000005452";"";"-2.760,00";"220.088,40";""
"12.01.2024";"12.01.2024";"NETS terminalleje";"";"-1.046,25";"219.042,15";""
"12.01.2024";"12.01.2024";"Til Telenor A/S";"";"-378,38";"218.663,77";""
"12.01.2024";"12.01.2024";"Overførsel                          -SE MEDD.";"";"13.912,30";"232.576,07";""
"12.01.2024";"12.01.2024";"Nets 0040 8822884                   -SE MEDD.";"";"10.910,24";"243.486,31";""
"12.01.2024";"12.01.2024";"LS 21865 CARLSBERG DANMARK A/S";"";"-208,50";"243.277,81";""
"12.01.2024";"12.01.2024";"DK  3257668 108645110850 11.01";"";"5.698,10";"248.975,91";""
"12.01.2024";"12.01.2024";"DK  3257668 401120800000 11.01";"";"438,00";"249.413,91";""
"12.01.2024";"12.01.2024";"Feriepenge";"";"-7.953,87";"241.460,04";""
"15.01.2024";"15.01.2024";"Mealo: 16378                        -SE MEDD.";"";"23.068,26";"264.528,30";""
"15.01.2024";"15.01.2024";"Henri Lee - udlæg";"";"-1.000,00";"263.528,30";""
"15.01.2024";"15.01.2024";"DK  3257668 108645111050 12.01";"";"2.398,00";"265.926,30";""
"15.01.2024";"15.01.2024";"DK  3257668 401220800000 12.01";"";"828,00";"266.754,30";""
"15.01.2024";"15.01.2024";"LS 46868 THAI FRESH IMPORT/EKSPORT";"";"-7.466,63";"259.287,67";""
"15.01.2024";"15.01.2024";"Afdrag på gæld Jarvinen";"";"-10.000,00";"249.287,67";""
"15.01.2024";"15.01.2024";"DK  3257668 108645111250 13.01";"";"2.511,00";"251.798,67";""
"15.01.2024";"15.01.2024";"DK  3257668 108645111450 14.01";"";"1.162,00";"252.960,67";""
"15.01.2024";"15.01.2024";"DK  3257668 401320800000 13.01";"";"795,00";"253.755,67";""
"15.01.2024";"15.01.2024";"DK  3257668 401420800000 14.01";"";"1.110,00";"254.865,67";""
"16.01.2024";"16.01.2024";"Nets 0041 8822884                   -SE MEDD.";"";"4.090,91";"258.956,58";""
"16.01.2024";"16.01.2024";"Nets 0042 8822884                   -SE MEDD.";"";"3.767,94";"262.724,52";""
"17.01.2024";"17.01.2024";"Overførsel                          -SE MEDD.";"";"13.777,75";"276.502,27";""
"17.01.2024";"17.01.2024";"Nets 0043 8822884                   -SE MEDD.";"";"5.356,76";"281.859,03";""
"17.01.2024";"17.01.2024";"DK  3257668 108645111750 16.01";"";"3.926,50";"285.785,53";""
"17.01.2024";"17.01.2024";"DK  3257668 401620800000 16.01";"";"1.876,00";"287.661,53";""
"17.01.2024";"17.01.2024";"A-skat";"";"-37.644,00";"250.017,53";""
"18.01.2024";"18.01.2024";"Nets 0044 8822884                   -SE MEDD.";"";"2.376,75";"252.394,28";""
"18.01.2024";"18.01.2024";"DK  3257668 108645111950 17.01";"";"3.529,00";"255.923,28";""
"18.01.2024";"18.01.2024";"DK  3257668 401720800000 17.01";"";"551,00";"256.474,28";""
"18.01.2024";"18.01.2024";"LS 46868 THAI FRESH IMPORT/EKSPORT";"";"-2.717,50";"253.756,78";""
"18.01.2024";"18.01.2024";"Til SJ.MEDIER ANN.";"";"-525,00";"253.231,78";""
"18.01.2024";"18.01.2024";"Henri Lee udlæg - Hjem & Fix";"";"-1.245,00";"251.986,78";""
"19.01.2024";"19.01.2024";"DK  3257668 108645112150 18.01";"";"1.590,00";"253.576,78";""
"19.01.2024";"19.01.2024";"Nets 0045 8822884                   -SE MEDD.";"";"1.163,80";"254.740,58";""
"19.01.2024";"19.01.2024";"Til SJ.MEDIER ANN.";"";"-525,00";"254.215,58";""
"19.01.2024";"19.01.2024";"Til e-conomic.dk";"";"-1.020,81";"253.194,77";""
"22.01.2024";"22.01.2024";"Mealo: 16523                        -SE MEDD.";"";"29.829,39";"283.024,16";""
"22.01.2024";"22.01.2024";"Remondis";"";"-2.374,41";"280.649,75";""
"22.01.2024";"22.01.2024";"DK  3257668 108645112350 19.01";"";"3.184,00";"283.833,75";""
"22.01.2024";"22.01.2024";"DK  3257668 401920800000 19.01";"";"500,00";"284.333,75";""
"22.01.2024";"22.01.2024";"LS 46868 THAI FRESH IMPORT/EKSPORT";"";"-7.590,00";"276.743,75";""
"22.01.2024";"22.01.2024";"DK  3257668 108645112550 20.01";"";"4.461,00";"281.204,75";""
"22.01.2024";"22.01.2024";"DK  3257668 402020800000 20.01";"";"644,00";"281.848,75";""
"22.01.2024";"22.01.2024";"DK  3257668 402120800000 21.01";"";"579,00";"282.427,75";""
"22.01.2024";"22.01.2024";"Henri Lee - udlæg inco";"";"-13.500,00";"268.927,75";""
"23.01.2024";"23.01.2024";"Til SJ.MEDIER ANN.";"";"-525,00";"268.402,75";""
"23.01.2024";"23.01.2024";"Overførsel                          -SE MEDD.";"";"12.986,10";"281.388,85";""
"23.01.2024";"23.01.2024";"Nets 0046 8822884                   -SE MEDD.";"";"1.941,43";"283.330,28";""
"23.01.2024";"23.01.2024";"Nets 0047 8822884                   -SE MEDD.";"";"4.088,96";"287.419,24";""
"24.01.2024";"24.01.2024";"Nets 0048 8822884                   -SE MEDD.";"";"8.733,52";"296.152,76";""
"24.01.2024";"24.01.2024";"DK  3257668 108645113050 23.01";"";"3.842,01";"299.994,77";""
"24.01.2024";"24.01.2024";"DK  3257668 402320800000 23.01";"";"792,00";"300.786,77";""
"24.01.2024";"24.01.2024";"LS 41033 ESMILEY A/S";"";"-1.236,38";"299.550,39";""
"24.01.2024";"24.01.2024";"Udlæg André-inco";"";"-16.493,90";"283.056,49";""
"24.01.2024";"24.01.2024";"Henri Lee- udlæg";"";"-1.000,00";"282.056,49";""
"24.01.2024";"24.01.2024";"Henri Lee- udlæg- transport";"";"-550,02";"281.506,47";""
"25.01.2024";"25.01.2024";"Nets 0049 8822884                   -SE MEDD.";"";"793,41";"282.299,88";""
"25.01.2024";"25.01.2024";"DK  3257668 402420800000 24.01";"";"2.609,00";"284.908,88";""
"25.01.2024";"25.01.2024";"LS 46868 THAI FRESH IMPORT/EKSPORT";"";"-3.906,25";"281.002,63";""
"26.01.2024";"26.01.2024";"Nets 0050 8822884                   -SE MEDD.";"";"2.906,83";"283.909,46";""
"26.01.2024";"26.01.2024";"DK  3257668 108645112750 21.01";"";"2.754,00";"286.663,46";""
"26.01.2024";"26.01.2024";"DK  3257668 108645113250 24.01";"";"2.508,00";"289.171,46";""
"29.01.2024";"29.01.2024";"Mealo: 16674                        -SE MEDD.";"";"24.603,09";"313.774,55";""
"29.01.2024";"29.01.2024";"Overførsel                          -SE MEDD.";"";"9.737,80";"323.512,35";""
"29.01.2024";"29.01.2024";"DK  3257668 108645113450 25.01";"";"1.162,00";"324.674,35";""
"29.01.2024";"29.01.2024";"DK  3257668 108645113650 26.01";"";"4.238,00";"328.912,35";""
"29.01.2024";"29.01.2024";"DK  3257668 402620800000 26.01";"";"1.299,50";"330.211,85";""
"29.01.2024";"29.01.2024";"LS 46868 THAI FRESH IMPORT/EKSPORT";"";"-5.333,75";"324.878,10";""
"29.01.2024";"29.01.2024";"DK  3257668 108645113850 27.01";"";"2.937,00";"327.815,10";""
"29.01.2024";"29.01.2024";"DK  3257668 108645114050 28.01";"";"1.383,00";"329.198,10";""
"29.01.2024";"29.01.2024";"DK  3257668 402720800000 27.01";"";"939,60";"330.137,70";""
"29.01.2024";"29.01.2024";"DK  3257668 402820800000 28.01";"";"1.573,00";"331.710,70";""
"29.01.2024";"29.01.2024";"Udlæg André";"";"-10.357,43";"321.353,27";""
"30.01.2024";"30.01.2024";"Nets 0051 8822884                   -SE MEDD.";"";"2.854,87";"324.208,14";""
"30.01.2024";"30.01.2024";"Nets 0052 8822884                   -SE MEDD.";"";"5.025,80";"329.233,94";""
"30.01.2024";"30.01.2024";"Wolt Drive INVWAWDNK1000006224";"";"-3.381,25";"325.852,69";""
"30.01.2024";"30.01.2024";"Løn";"";"-99.048,76";"226.803,93";""
"30.01.2024";"30.01.2024";"Overførsel";"";"-116,35";"226.687,58";""
"31.01.2024";"31.01.2024";"Omkostninger, Netbank og Mobilbank";"";"-112,00";"226.575,58";""
"31.01.2024";"31.01.2024";"Til Onlinepos Aps";"";"-2.122,50";"224.453,08";""
"31.01.2024";"31.01.2024";"Til Telenor A/S";"";"-857,69";"223.595,39";""
"31.01.2024";"31.01.2024";"Nets 0053 8822884                   -SE MEDD.";"";"5.361,40";"228.956,79";""
"31.01.2024";"31.01.2024";"Fra Tania Damsgaard                 -SE MEDD.";"";"250,00";"229.206,79";""
"01.02.2024";"01.02.2024";"Nets 0054 8822884                   -SE MEDD.";"";"1.826,73";"231.033,52";""
"01.02.2024";"01.02.2024";"DK  3257668 108645114350 30.01";"";"2.255,00";"233.288,52";""
"01.02.2024";"01.02.2024";"DK  3257668 108645114550 31.01";"";"2.786,00";"236.074,52";""
"01.02.2024";"01.02.2024";"DK  3257668 403120800000 31.01";"";"1.852,00";"237.926,52";""
"01.02.2024";"01.02.2024";"LS 46868 THAI FRESH IMPORT/EKSPORT";"";"-4.823,75";"233.102,77";""
"02.02.2024";"02.02.2024";"Overførsel                          -SE MEDD.";"";"16.226,20";"249.328,97";""
"02.02.2024";"02.02.2024";"Nets 0055 8822884                   -SE MEDD.";"";"3.202,61";"252.531,58";""
"02.02.2024";"02.02.2024";"DK  3257668 108645114750 01.02";"";"3.596,00";"256.127,58";""
"02.02.2024";"02.02.2024";"LS 46868 THAI FRESH IMPORT/EKSPORT";"";"-2.717,50";"253.410,08";""
"05.02.2024";"05.02.2024";"Mealo: 16825                        -SE MEDD.";"";"26.240,09";"279.650,17";""
"05.02.2024";"05.02.2024";"Til SJ.MEDIER ANN.";"";"-525,00";"279.125,17";""
"05.02.2024";"05.02.2024";"Til NRGI ELSALG A/S";"";"-9.541,87";"269.583,30";""
"05.02.2024";"05.02.2024";"Til KOSAN GAS A/S";"";"-1.498,76";"268.084,54";""
"05.02.2024";"05.02.2024";"Til 4387 2043459";"";"-3.053,46";"265.031,08";""
"05.02.2024";"05.02.2024";"DK  3257668 108645114950 02.02";"";"5.215,00";"270.246,08";""
"05.02.2024";"05.02.2024";"DK  3257668 403320800000 02.02";"";"415,00";"270.661,08";""
"05.02.2024";"05.02.2024";"LS 46868 THAI FRESH IMPORT/EKSPORT";"";"-4.482,75";"266.178,33";""
"05.02.2024";"05.02.2024";"LS 47422 DAKA DENMARK A/S";"";"-678,21";"265.500,12";""
"05.02.2024";"05.02.2024";"DK  3257668 108645115150 03.02";"";"3.825,00";"269.325,12";""
"05.02.2024";"05.02.2024";"DK  3257668 108645115350 04.02";"";"10.777,00";"280.102,12";""
"05.02.2024";"05.02.2024";"DK  3257668 403420800000 03.02";"";"338,00";"280.440,12";""
"05.02.2024";"05.02.2024";"DK  3257668 403520800000 04.02";"";"397,00";"280.837,12";""
"06.02.2024";"06.02.2024";"Nets 0056 8822884                   -SE MEDD.";"";"4.504,64";"285.341,76";""
"06.02.2024";"06.02.2024";"Nets 0057 8822884                   -SE MEDD.";"";"4.783,11";"290.124,87";""
"06.02.2024";"06.02.2024";"ATP";"";"-2.461,30";"287.663,57";""
"07.02.2024";"07.02.2024";"Overførsel                          -SE MEDD.";"";"11.828,35";"299.491,92";""
"07.02.2024";"07.02.2024";"Nets 0058 8822884                   -SE MEDD.";"";"6.414,56";"305.906,48";""
"07.02.2024";"07.02.2024";"PBS DK Abon 3257668 010124-310124";"";"-415,64";"305.490,84";""
"07.02.2024";"07.02.2024";"LS 21865 CARLSBERG DANMARK A/S";"";"-4.219,71";"301.271,13";""
"07.02.2024";"07.02.2024";"DK  3257668 108645115650 06.02";"";"1.405,00";"302.676,13";""
"07.02.2024";"07.02.2024";"DK  3257668 403720800000 06.02";"";"1.913,00";"304.589,13";""
"07.02.2024";"07.02.2024";"Til EJENDOMS. CAROMAT";"";"-37.989,13";"266.600,00";""
"07.02.2024";"07.02.2024";"Til SPG A/S";"";"-2.672,25";"263.927,75";""
"07.02.2024";"07.02.2024";"Marius Dud.udlæg LG";"";"-8.619,48";"255.308,27";""
"07.02.2024";"07.02.2024";"P Bon-udlæg LG";"";"-16.108,33";"239.199,94";""
"08.02.2024";"08.02.2024";"Nets 0059 8822884                   -SE MEDD.";"";"1.729,81";"240.929,75";""
"08.02.2024";"08.02.2024";"DK  3257668 108645115850 07.02";"";"5.023,00";"245.952,75";""
"08.02.2024";"08.02.2024";"DK  3257668 403820800000 07.02";"";"2.461,00";"248.413,75";""
"08.02.2024";"08.02.2024";"LS 46868 THAI FRESH IMPORT/EKSPORT";"";"-4.562,50";"243.851,25";""
"09.02.2024";"09.02.2024";"Nets 0060 8822884                   -SE MEDD.";"";"1.054,57";"244.905,82";""
"09.02.2024";"09.02.2024";"DK  3257668 108645116050 08.02";"";"2.446,00";"247.351,82";""
"09.02.2024";"09.02.2024";"DK  3257668 403920800000 08.02";"";"520,00";"247.871,82";""
"09.02.2024";"09.02.2024";"Til SPG A/S";"";"-1.936,25";"245.935,57";""
"12.02.2024";"12.02.2024";"Mealo: 16976                        -SE MEDD.";"";"28.960,00";"274.895,57";""
"12.02.2024";"12.02.2024";"DK  3257668 108645116250 09.02";"";"3.663,00";"278.558,57";""
"12.02.2024";"12.02.2024";"DK  3257668 404020800000 09.02";"";"1.217,80";"279.776,37";""
"12.02.2024";"12.02.2024";"LS 46868 THAI FRESH IMPORT/EKSPORT";"";"-8.935,75";"270.840,62";""
"12.02.2024";"12.02.2024";"DK  3257668 108645116450 10.02";"";"2.507,00";"273.347,62";""
"12.02.2024";"12.02.2024";"DK  3257668 108645116650 11.02";"";"1.336,00";"274.683,62";""
"12.02.2024";"12.02.2024";"DK  3257668 404120800000 10.02";"";"400,00";"275.083,62";""
"12.02.2024";"12.02.2024";"DK  3257668 404220800000 11.02";"";"726,00";"275.809,62";""
"12.02.2024";"12.02.2024";"A-skat";"";"-40.668,00";"235.141,62";""
"13.02.2024";"13.02.2024";"Overførsel                          -SE MEDD.";"";"17.905,60";"253.047,22";""
"13.02.2024";"13.02.2024";"Nets 0061 8822884                   -SE MEDD.";"";"595,80";"253.643,02";""
"13.02.2024";"13.02.2024";"Nets 0062 8822884                   -SE MEDD.";"";"2.922,92";"256.565,94";""
"14.02.2024";"14.02.2024";"Nets 0063 8822884                   -SE MEDD.";"";"6.821,10";"263.387,04";""
"14.02.2024";"14.02.2024";"DK  3257668 108645116950 13.02";"";"3.628,00";"267.015,04";""
"14.02.2024";"14.02.2024";"Feriepenge";"";"-8.643,95";"258.371,09";""
"15.02.2024";"15.02.2024";"Nets 0064 8822884                   -SE MEDD.";"";"2.552,89";"260.923,98";""
"15.02.2024";"15.02.2024";"DK  3257668 108645117150 14.02";"";"4.997,00";"265.920,98";""
"15.02.2024";"15.02.2024";"DK  3257668 404520800000 14.02";"";"449,00";"266.369,98";""
"15.02.2024";"15.02.2024";"LS 46868 THAI FRESH IMPORT/EKSPORT";"";"-3.970,00";"262.399,98";""
"16.02.2024";"16.02.2024";"DK  3257668 108645117350 15.02";"";"5.821,00";"268.220,98";""
"16.02.2024";"16.02.2024";"DK  3257668 404620800000 15.02";"";"2.252,00";"270.472,98";""
"16.02.2024";"16.02.2024";"Nets 0065 8822884                   -SE MEDD.";"";"5.403,57";"275.876,55";""
"16.02.2024";"16.02.2024";"Sjællandske Medier A/S";"";"-525,00";"275.351,55";""
"16.02.2024";"16.02.2024";"Til SJ.MEDIER ANN.";"";"-525,00";"274.826,55";""
"19.02.2024";"19.02.2024";"Mealo: 17125                        -SE MEDD.";"";"22.079,39";"296.905,94";""
"19.02.2024";"19.02.2024";"Overførsel                          -SE MEDD.";"";"11.076,60";"307.982,54";""
"19.02.2024";"19.02.2024";"Udlæg André-Inco";"";"-28.494,85";"279.487,69";""
"19.02.2024";"19.02.2024";"DK  3257668 108645117550 16.02";"";"3.110,00";"282.597,69";""
"19.02.2024";"19.02.2024";"DK  3257668 404720800000 16.02";"";"2.044,00";"284.641,69";""
"19.02.2024";"19.02.2024";"LS 46868 THAI FRESH IMPORT/EKSPORT";"";"-4.457,50";"280.184,19";""
"19.02.2024";"19.02.2024";"DK  3257668 108645117850 17.02";"";"5.345,80";"285.529,99";""
"19.02.2024";"19.02.2024";"DK  3257668 108645118050 18.02";"";"495,00";"286.024,99";""
"19.02.2024";"19.02.2024";"DK  3257668 404820800000 17.02";"";"1.612,00";"287.636,99";""
"19.02.2024";"19.02.2024";"DK  3257668 404920800000 18.02";"";"2.998,00";"290.634,99";""
"20.02.2024";"20.02.2024";"Nets 0066 8822884                   -SE MEDD.";"";"3.841,74";"294.476,73";""
"20.02.2024";"20.02.2024";"Nets 0067 8822884                   -SE MEDD.";"";"4.161,67";"298.638,40";""
"21.02.2024";"21.02.2024";"Henri Lee - udlæg inco";"";"-5.255,67";"293.382,73";""
"21.02.2024";"21.02.2024";"Nets 0068 8822884                   -SE MEDD.";"";"6.542,21";"299.924,94";""
"21.02.2024";"21.02.2024";"LS 21865 CARLSBERG DANMARK A/S";"";"-2.295,71";"297.629,23";""
"21.02.2024";"21.02.2024";"DK  3257668 108645118350 20.02";"";"3.964,00";"301.593,23";""
"21.02.2024";"21.02.2024";"DK  3257668 405120800000 20.02";"";"579,00";"302.172,23";""
"22.02.2024";"22.02.2024";"Overførsel                          -SE MEDD.";"";"9.962,60";"312.134,83";""
"22.02.2024";"22.02.2024";"Nets 0069 8822884                   -SE MEDD.";"";"1.384,23";"313.519,06";""
"22.02.2024";"22.02.2024";"DK  3257668 108645118550 21.02";"";"5.098,20";"318.617,26";""
"22.02.2024";"22.02.2024";"DK  3257668 405220800000 21.02";"";"1.557,00";"320.174,26";""
"22.02.2024";"22.02.2024";"LS 46868 THAI FRESH IMPORT/EKSPORT";"";"-4.901,00";"315.273,26";""
"22.02.2024";"22.02.2024";"Netbank gebyr oprettelse af kont";"";"-175,00";"315.098,26";""
"22.02.2024";"22.02.2024";"Til Telenor - Arhaan Thai";"";"-0,41";"315.097,85";""
"22.02.2024";"22.02.2024";"Til Remondis";"";"-2.627,86";"312.469,99";""
"22.02.2024";"22.02.2024";"Udlæg André";"";"-11.561,06";"300.908,93";""
"22.02.2024";"22.02.2024";"Til Verisure A/S";"";"-756,65";"300.152,28";""
"23.02.2024";"23.02.2024";"Nets 0070 8822884                   -SE MEDD.";"";"4.501,67";"304.653,95";""
"23.02.2024";"23.02.2024";"Udbetaling fra SKAT                 -SE MEDD.";"";"370,29";"305.024,24";""
"23.02.2024";"23.02.2024";"DK  3257668 108645118750 22.02";"";"2.627,00";"307.651,24";""
"23.02.2024";"23.02.2024";"Til SJ.MEDIER ANN.";"";"-525,00";"307.126,24";""
"23.02.2024";"23.02.2024";"Afdrag lån Jarvinen";"";"-10.000,00";"297.126,24";""
"23.02.2024";"23.02.2024";"Tingstad                            -SE MEDD.";"";"-6.329,00";"290.797,24";""
"26.02.2024";"26.02.2024";"Mealo: 17281                        -SE MEDD.";"";"22.718,61";"313.515,85";""
"26.02.2024";"26.02.2024";"DK  3257668 108645118950 23.02";"";"5.912,00";"319.427,85";""
"26.02.2024";"26.02.2024";"DK  3257668 405420800000 23.02";"";"1.220,00";"320.647,85";""
"26.02.2024";"26.02.2024";"LS 46868 THAI FRESH IMPORT/EKSPORT";"";"-6.877,50";"313.770,35";""
"26.02.2024";"26.02.2024";"DK  3257668 108645119150 24.02";"";"2.650,00";"316.420,35";""
"26.02.2024";"26.02.2024";"DK  3257668 108645119350 25.02";"";"2.844,00";"319.264,35";""
"26.02.2024";"26.02.2024";"DK  3257668 405520800000 24.02";"";"2.273,00";"321.537,35";""
"26.02.2024";"26.02.2024";"DK  3257668 405620800000 25.02";"";"890,00";"322.427,35";""
"27.02.2024";"27.02.2024";"Til Verisure A/S";"";"-950,00";"321.477,35";""
"27.02.2024";"27.02.2024";"Overførsel                          -SE MEDD.";"";"19.040,45";"340.517,80";""
"27.02.2024";"27.02.2024";"Nets 0071 8822884                   -SE MEDD.";"";"3.899,50";"344.417,30";""
"27.02.2024";"27.02.2024";"Nets 0072 8822884                   -SE MEDD.";"";"4.793,72";"349.211,02";""
"27.02.2024";"27.02.2024";"Omkostninger, Netbank og Mobilbank";"";"-2.500,00";"346.711,02";""
"28.02.2024";"28.02.2024";"LS 21865 CARLSBERG DANMARK A/S";"";"-1.587,50";"345.123,52";""
"28.02.2024";"28.02.2024";"DK  3257668 108645119550 27.02";"";"1.348,00";"346.471,52";""
"28.02.2024";"28.02.2024";"Nets 0073 8822884                   -SE MEDD.";"";"6.270,03";"352.741,55";""
"28.02.2024";"28.02.2024";"Løn";"";"-98.603,28";"254.138,27";""
"28.02.2024";"28.02.2024";"Overførsel";"";"-103,51";"254.034,76";""
"29.02.2024";"29.02.2024";"Omkostninger, Netbank og Mobilbank";"";"-138,00";"253.896,76";""
"29.02.2024";"29.02.2024";"1 Visa Debit, årlig kortbetaling";"";"-150,00";"253.746,76";""
"29.02.2024";"29.02.2024";"Wolt Drive";"";"-4.442,50";"249.304,26";""
"29.02.2024";"29.02.2024";"Til Onlinepos Aps";"";"-2.122,50";"247.181,76";""
"29.02.2024";"29.02.2024";"Til NRGI ELSALG A/S";"";"-11.031,84";"236.149,92";""
"29.02.2024";"29.02.2024";"DK  3257668 108645119750 28.02";"";"2.936,00";"239.085,92";""
"29.02.2024";"29.02.2024";"LS 46868 THAI FRESH IMPORT/EKSPORT";"";"-3.713,75";"235.372,17";""
"29.02.2024";"29.02.2024";"Nets 0074 8822884                   -SE MEDD.";"";"1.045,63";"236.417,80";""
"29.02.2024";"29.02.2024";"Fra Tania Damsgaard                 -SE MEDD.";"";"250,00";"236.667,80";""
"29.02.2024";"29.02.2024";"Moms Til SKATTEKONTOEN";"";"-26.580,00";"210.087,80";""
"01.03.2024";"01.03.2024";"Nets 0075 8822884                   -SE MEDD.";"";"3.610,46";"213.698,26";""
"01.03.2024";"01.03.2024";"KFT";"";"-18.100,30";"195.597,96";""
"01.03.2024";"01.03.2024";"Tryg Arbejdsskade";"";"-19.372,97";"176.224,99";""
"01.03.2024";"01.03.2024";"Tryg Erhvervsforsikring";"";"-13.452,41";"162.772,58";""
"01.03.2024";"01.03.2024";"DK  3257668 108645119950 29.02";"";"3.534,00";"166.306,58";""
"01.03.2024";"01.03.2024";"DK  3257668 406020800000 29.02";"";"507,00";"166.813,58";""
"04.03.2024";"04.03.2024";"Overførsel                          -SE MEDD.";"";"8.953,90";"175.767,48";""
"04.03.2024";"04.03.2024";"Mealo: 17442                        -SE MEDD.";"";"23.280,76";"199.048,24";""
"04.03.2024";"04.03.2024";"DK  3257668 108645120150 01.03";"";"6.820,00";"205.868,24";""
"04.03.2024";"04.03.2024";"DK  3257668 406120800000 01.03";"";"1.442,00";"207.310,24";""
"04.03.2024";"04.03.2024";"LS 46868 THAI FRESH IMPORT/EKSPORT";"";"-5.290,00";"202.020,24";""
"04.03.2024";"04.03.2024";"DK  3257668 108645120350 02.03";"";"4.302,00";"206.322,24";""
"04.03.2024";"04.03.2024";"DK  3257668 108645120550 03.03";"";"3.673,00";"209.995,24";""
"04.03.2024";"04.03.2024";"DK  3257668 406220800000 02.03";"";"2.752,00";"212.747,24";""
"05.03.2024";"05.03.2024";"Nets 0076 8822884                   -SE MEDD.";"";"3.222,29";"215.969,53";""
"05.03.2024";"05.03.2024";"Nets 0077 8822884                   -SE MEDD.";"";"6.737,74";"222.707,27";""
"06.03.2024";"06.03.2024";"Til 3100 3231158200";"";"-675,94";"222.031,33";""
"06.03.2024";"06.03.2024";"Nets 0078 8822884                   -SE MEDD.";"";"8.467,14";"230.498,47";""
"06.03.2024";"06.03.2024";"PBS DK Abon 3257668 010224-290224";"";"-545,74";"229.952,73";""
"06.03.2024";"06.03.2024";"LS 21865 CARLSBERG DANMARK A/S";"";"-2.860,68";"227.092,05";""
"06.03.2024";"06.03.2024";"DK  3257668 108645120850 05.03";"";"1.856,00";"228.948,05";""
"06.03.2024";"06.03.2024";"DK  3257668 406520800000 05.03";"";"89,00";"229.037,05";""
"06.03.2024";"06.03.2024";"LS 47422 DAKA DENMARK A/S";"";"-675,94";"228.361,11";""
"07.03.2024";"07.03.2024";"Overførsel                          -SE MEDD.";"";"13.908,00";"242.269,11";""
"07.03.2024";"07.03.2024";"Nets 0079 8822884                   -SE MEDD.";"";"3.253,72";"245.522,83";""
"07.03.2024";"07.03.2024";"DK  3257668 108645121050 06.03";"";"1.835,00";"247.357,83";""
"07.03.2024";"07.03.2024";"LS 46868 THAI FRESH IMPORT/EKSPORT";"";"-5.650,00";"241.707,83";""
"08.03.2024";"08.03.2024";"Nets 0080 8822884                   -SE MEDD.";"";"5.491,81";"247.199,64";""
"08.03.2024";"08.03.2024";"DK  3257668 108645121250 07.03";"";"2.531,00";"249.730,64";""
"11.03.2024";"11.03.2024";"Mealo: 17609                        -SE MEDD.";"";"26.768,33";"276.498,97";""
"11.03.2024";"11.03.2024";"Til Vision Watercare Servicebilen";"";"-4.097,00";"272.401,97";""
"11.03.2024";"11.03.2024";"Philipson Wine 2669770";"";"-2.891,52";"269.510,45";""
"11.03.2024";"11.03.2024";"VD 00001 COOP KVICKLY TAASTRUP";"";"-116,20";"269.394,25";""
"11.03.2024";"11.03.2024";"VD 00004 INCO CC GLOSTRUP A/S";"";"-2.200,25";"267.194,00";""
"11.03.2024";"11.03.2024";"Til EJENDOMS. CAROMAT";"";"-36.293,92";"230.900,08";""
"11.03.2024";"11.03.2024";"Husleje TH64";"";"-36.293,92";"194.606,16";""
"11.03.2024";"11.03.2024";"K.P. Electric ApS";"";"-660,00";"193.946,16";""
"11.03.2024";"11.03.2024";"Afdrag lån Jarvinen";"";"-10.000,00";"183.946,16";""
"11.03.2024";"11.03.2024";"DK  3257668 108645121450 08.03";"";"8.460,00";"192.406,16";""
"11.03.2024";"11.03.2024";"DK  3257668 406820800000 08.03";"";"1.911,00";"194.317,16";""
"11.03.2024";"11.03.2024";"LS 46868 THAI FRESH IMPORT/EKSPORT";"";"-8.111,25";"186.205,91";""
"11.03.2024";"11.03.2024";"DK  3257668 108645121650 09.03";"";"4.590,00";"190.795,91";""
"11.03.2024";"11.03.2024";"DK  3257668 108645121850 10.03";"";"4.136,00";"194.931,91";""
"11.03.2024";"11.03.2024";"DK  3257668 406920800000 09.03";"";"509,00";"195.440,91";""
"11.03.2024";"11.03.2024";"A-skat";"";"-37.737,00";"157.703,91";""
"11.03.2024";"11.03.2024";"VD 00005 INCO CC KOEBENHAVN A/S";"";"-399,90";"157.304,01";""
"12.03.2024";"12.03.2024";"Nets 0081 8822884                   -SE MEDD.";"";"1.284,93";"158.588,94";""
"12.03.2024";"12.03.2024";"Nets 0082 8822884                   -SE MEDD.";"";"3.502,31";"162.091,25";""
"12.03.2024";"12.03.2024";"Overførsel                          -SE MEDD.";"";"13.407,35";"175.498,60";""
"12.03.2024";"12.03.2024";"Udlæg Inco André";"";"-16.420,61";"159.077,99";""
"12.03.2024";"12.03.2024";"VeriSure Alarm";"";"-950,00";"158.127,99";""
"12.03.2024";"12.03.2024";"SN Artikelbanner";"";"-525,00";"157.602,99";""
"12.03.2024";"12.03.2024";"Derman Pack 002783";"";"-1.375,00";"156.227,99";""
"12.03.2024";"12.03.2024";"Derman Pack 001501";"";"-3.187,50";"153.040,49";""
"12.03.2024";"12.03.2024";"Derman Pack 002174";"";"-550,00";"152.490,49";""
"12.03.2024";"12.03.2024";"VD 00003 IKEA.DK";"";"-3.303,00";"149.187,49";""
"13.03.2024";"13.03.2024";"Nets 0083 8822884                   -SE MEDD.";"";"6.156,60";"155.344,09";""
"13.03.2024";"13.03.2024";"DK  3257668 108645121950 12.03";"";"3.484,00";"158.828,09";""
"13.03.2024";"13.03.2024";"DK  3257668 407220800000 12.03";"";"750,00";"159.578,09";""
"13.03.2024";"13.03.2024";"VD 00006 INCO CC GLOSTRUP A/S";"";"-4.232,50";"155.345,59";""
"14.03.2024";"14.03.2024";"Nets 0084 8822884                   -SE MEDD.";"";"1.382,25";"156.727,84";""
"14.03.2024";"14.03.2024";"DK  3257668 108645122150 13.03";"";"2.727,00";"159.454,84";""
"14.03.2024";"14.03.2024";"LS 46868 THAI FRESH IMPORT/EKSPORT";"";"-3.445,25";"156.009,59";""
"14.03.2024";"14.03.2024";"Feriepenge";"";"-8.583,13";"147.426,46";""
"15.03.2024";"15.03.2024";"Nets 0085 8822884                   -SE MEDD.";"";"2.888,64";"150.315,10";""
"15.03.2024";"15.03.2024";"DK  3257668 108645122350 14.03";"";"4.800,00";"155.115,10";""
"15.03.2024";"15.03.2024";"DK  3257668 407420800000 14.03";"";"1.903,00";"157.018,10";""
"15.03.2024";"15.03.2024";"Philipson Wine";"";"-2.850,00";"154.168,10";""
"15.03.2024";"15.03.2024";"SN Artikelbanner";"";"-525,00";"153.643,10";""
"18.03.2024";"18.03.2024";"Mealo: 17780                        -SE MEDD.";"";"26.318,86";"179.961,96";""
"18.03.2024";"18.03.2024";"VD 00009 DK-Laaseservice";"";"-760,00";"179.201,96";""
"18.03.2024";"18.03.2024";"VD 00010 PSEMUSICON";"";"-813,25";"178.388,71";""
"18.03.2024";"18.03.2024";"VD 00007 AnyLamp";"";"-1.035,30";"177.353,41";""
"18.03.2024";"18.03.2024";"VD 00011 INCO CC GLOSTRUP A/S";"";"-5.838,24";"171.515,17";""
"18.03.2024";"18.03.2024";"Derman Pack 003639";"";"-2.720,00";"168.795,17";""
"18.03.2024";"18.03.2024";"DK  3257668 108645122450 15.03";"";"4.968,00";"173.763,17";""
"18.03.2024";"18.03.2024";"DK  3257668 407520800000 15.03";"";"1.352,00";"175.115,17";""
"18.03.2024";"18.03.2024";"LS 46868 THAI FRESH IMPORT/EKSPORT";"";"-8.116,25";"166.998,92";""
"18.03.2024";"18.03.2024";"DK  3257668 108645122650 16.03";"";"4.487,00";"171.485,92";""
"18.03.2024";"18.03.2024";"DK  3257668 108645122850 17.03";"";"3.229,60";"174.715,52";""
"18.03.2024";"18.03.2024";"DK  3257668 407620800000 16.03";"";"576,00";"175.291,52";""
"18.03.2024";"18.03.2024";"DK  3257668 407720800000 17.03";"";"509,00";"175.800,52";""
"19.03.2024";"19.03.2024";"Overførsel                          -SE MEDD.";"";"9.693,45";"185.493,97";""
"19.03.2024";"19.03.2024";"Nets 0086 8822884                   -SE MEDD.";"";"2.951,20";"188.445,17";""
"19.03.2024";"19.03.2024";"Nets 0087 8822884                   -SE MEDD.";"";"3.668,44";"192.113,61";""
"20.03.2024";"20.03.2024";"Remondis";"";"-3.135,35";"188.978,26";""
"20.03.2024";"20.03.2024";"LS 21865 CARLSBERG DANMARK A/S";"";"-5.561,23";"183.417,03";""
"20.03.2024";"20.03.2024";"DK  3257668 108645123150 19.03";"";"2.559,00";"185.976,03";""
"20.03.2024";"20.03.2024";"Nets 0088 8822884                   -SE MEDD.";"";"6.029,76";"192.005,79";""
"20.03.2024";"20.03.2024";"JT Teknik rep opvask";"";"-3.416,88";"188.588,91";""
"21.03.2024";"21.03.2024";"DK  3257668 108645123350 20.03";"";"5.167,00";"193.755,91";""
"21.03.2024";"21.03.2024";"DK  3257668 408020800000 20.03";"";"343,00";"194.098,91";""
"21.03.2024";"21.03.2024";"LS 46868 THAI FRESH IMPORT/EKSPORT";"";"-5.741,25";"188.357,66";""
"21.03.2024";"21.03.2024";"Nets 0089 8822884                   -SE MEDD.";"";"2.880,43";"191.238,09";""
"22.03.2024";"22.03.2024";"LaserTryk 6760742";"";"-1.366,25";"189.871,84";""
"22.03.2024";"22.03.2024";"LaserTryk 6760741";"";"-1.767,50";"188.104,34";""
"22.03.2024";"22.03.2024";"SN Artikelbanner";"";"-525,00";"187.579,34";""
"22.03.2024";"22.03.2024";"DK  3257668 108645123550 21.03";"";"3.179,00";"190.758,34";""
"22.03.2024";"22.03.2024";"DK  3257668 408120800000 21.03";"";"1.184,00";"191.942,34";""
"22.03.2024";"22.03.2024";"Overførsel                          -SE MEDD.";"";"12.086,10";"204.028,44";""
"22.03.2024";"22.03.2024";"Nets 0090 8822884                   -SE MEDD.";"";"4.289,03";"208.317,47";""
"25.03.2024";"25.03.2024";"Mealo: 17949                        -SE MEDD.";"";"24.713,41";"233.030,88";""
"25.03.2024";"25.03.2024";"VD 00012 INCO CC GLOSTRUP A/S";"";"-4.416,81";"228.614,07";""
"25.03.2024";"25.03.2024";"DK  3257668 108645123750 22.03";"";"5.138,00";"233.752,07";""
"25.03.2024";"25.03.2024";"DK  3257668 408220800000 22.03";"";"1.705,00";"235.457,07";""
"25.03.2024";"25.03.2024";"LS 46868 THAI FRESH IMPORT/EKSPORT";"";"-6.785,25";"228.671,82";""
"25.03.2024";"25.03.2024";"DK  3257668 108645123950 23.03";"";"3.658,00";"232.329,82";""
"25.03.2024";"25.03.2024";"DK  3257668 108645124150 24.03";"";"5.583,00";"237.912,82";""
"25.03.2024";"25.03.2024";"DK  3257668 408320800000 23.03";"";"905,00";"238.817,82";""
"25.03.2024";"25.03.2024";"DK  3257668 408420800000 24.03";"";"551,00";"239.368,82";""
"26.03.2024";"26.03.2024";"Nets 0091 8822884                   -SE MEDD.";"";"4.909,63";"244.278,45";""
"26.03.2024";"26.03.2024";"Nets 0092 8822884                   -SE MEDD.";"";"4.799,76";"249.078,21";""
"26.03.2024";"26.03.2024";"Wolt Danmark DRIVE";"";"-3.266,25";"245.811,96";""
"26.03.2024";"26.03.2024";"Løn";"";"-92.378,97";"153.432,99";""
"26.03.2024";"26.03.2024";"Overførsel";"";"-213,51";"153.219,48";""
"27.03.2024";"27.03.2024";"DK  3257668 108645124450 26.03";"";"7.694,00";"160.913,48";""
"27.03.2024";"27.03.2024";"LaserTryk";"";"-1.846,63";"159.066,85";""
"27.03.2024";"27.03.2024";"Til Visionwatercare";"";"-2.768,00";"156.298,85";""
"27.03.2024";"27.03.2024";"Overførsel                          -SE MEDD.";"";"8.824,75";"165.123,60";""
"27.03.2024";"27.03.2024";"Nets 0093 8822884                   -SE MEDD.";"";"7.334,29";"172.457,89";""
"27.03.2024";"27.03.2024";"Omkostninger, Netbank og Mobilbank";"";"-338,50";"172.119,39";""
"27.03.2024";"27.03.2024";"Omkostninger, Netbank og Mobilbank";"";"-30,00";"172.089,39";""
"27.03.2024";"27.03.2024";"Omkostninger transaktioner";"";"-73,50";"172.015,89";""
"27.03.2024";"27.03.2024";"Fuldmagt via privat netbank";"";"-250,00";"171.765,89";""
"27.03.2024";"27.03.2024";"Grundbeløb, kvartalsafgift";"";"-400,00";"171.365,89";""
"27.03.2024";"27.03.2024";"35 Omkostninger overførselsservice";"";"-26,25";"171.339,64";""
"27.03.2024";"27.03.2024";"Fra Tania Damsgaard                 -SE MEDD.";"";"250,00";"171.589,64";""
"02.04.2024";"02.04.2024";"VD 00015 COOP KVICKLY TAASTRUP";"";"-159,95";"171.429,69";""
"02.04.2024";"02.04.2024";"VD 00014 COOP KVICKLY TAASTRUP";"";"-295,30";"171.134,39";""
"02.04.2024";"02.04.2024";"VD 00013 INCO CC GLOSTRUP A/S";"";"-5.912,44";"165.221,95";""
"02.04.2024";"02.04.2024";"VD 00016 INCO CC KOEBENHAVN A/S";"";"-2.586,94";"162.635,01";""
"02.04.2024";"02.04.2024";"Til Telenor A/S";"";"-378,38";"162.256,63";""
"02.04.2024";"02.04.2024";"BS ONLINEPOS APS";"";"-2.061,25";"160.195,38";""
"02.04.2024";"02.04.2024";"BS EJD. 643 TAASTRUP HOVEDGADE 64";"";"-51.135,58";"109.059,80";""
"02.04.2024";"02.04.2024";"LS 21865 CARLSBERG DANMARK A/S";"";"-4.066,41";"104.993,39";""
"02.04.2024";"02.04.2024";"DK  3257668 408720800000 27.03";"";"432,00";"105.425,39";""
"02.04.2024";"02.04.2024";"LS 46868 THAI FRESH IMPORT/EKSPORT";"";"-12.736,88";"92.688,51";""
"02.04.2024";"02.04.2024";"DK  3257668 108645124650 27.03";"";"2.433,30";"95.121,81";""
"02.04.2024";"02.04.2024";"DK  3257668 108645124750 28.03";"";"2.729,00";"97.850,81";""
"02.04.2024";"02.04.2024";"DK  3257668 108645124950 29.03";"";"1.988,00";"99.838,81";""
"02.04.2024";"02.04.2024";"DK  3257668 108645125150 30.03";"";"5.344,00";"105.182,81";""
"02.04.2024";"02.04.2024";"DK  3257668 108645125350 31.03";"";"6.089,00";"111.271,81";""
"02.04.2024";"02.04.2024";"DK  3257668 408820800000 28.03";"";"336,00";"111.607,81";""
"02.04.2024";"02.04.2024";"DK  3257668 408920800000 29.03";"";"465,00";"112.072,81";""
"02.04.2024";"02.04.2024";"DK  3257668 409020800000 30.03";"";"1.286,00";"113.358,81";""
"02.04.2024";"02.04.2024";"Mealo: 18114                        -SE MEDD.";"";"22.266,32";"135.625,13";""
"03.04.2024";"03.04.2024";"Nets 0094 8822884                   -SE MEDD.";"";"2.391,14";"138.016,27";""
"03.04.2024";"03.04.2024";"Nets 0095 8822884                   -SE MEDD.";"";"3.972,05";"141.988,32";""
"03.04.2024";"03.04.2024";"Overførsel                          -SE MEDD.";"";"20.320,35";"162.308,67";""
"03.04.2024";"03.04.2024";"PBS DK Abon 3257668 010324-310324";"";"-547,32";"161.761,35";""
"03.04.2024";"03.04.2024";"DK  3257668 108645125650 02.04";"";"2.402,00";"164.163,35";""
"03.04.2024";"03.04.2024";"NRGi elregning";"";"-10.080,87";"154.082,48";""
"03.04.2024";"03.04.2024";"SN Artikelbanner";"";"-525,00";"153.557,48";""
"04.04.2024";"04.04.2024";"Udlæg LG Jantana Maisoong";"";"-4.857,00";"148.700,48";""
"04.04.2024";"04.04.2024";"Udlæg LG Melanie Biava";"";"-16.084,33";"132.616,15";""
"04.04.2024";"04.04.2024";"Nets 0096 8822884                   -SE MEDD.";"";"12.515,83";"145.131,98";""
"04.04.2024";"04.04.2024";"LS 21865 CARLSBERG DANMARK A/S";"";"-2.284,30";"142.847,68";""
"04.04.2024";"04.04.2024";"DK  3257668 409420800000 03.04";"";"366,00";"143.213,68";""
"04.04.2024";"04.04.2024";"LS 46868 THAI FRESH IMPORT/EKSPORT";"";"-2.290,00";"140.923,68";""
"04.04.2024";"04.04.2024";"LS 47422 DAKA DENMARK A/S";"";"-708,65";"140.215,03";""
"04.04.2024";"04.04.2024";"Udlæg Henri Lee";"";"-10.000,00";"130.215,03";""
"04.04.2024";"04.04.2024";"VD 00017 INCO CC GLOSTRUP A/S";"";"-5.618,19";"124.596,84";""
"05.04.2024";"05.04.2024";"Nets 0097 8822884                   -SE MEDD.";"";"1.948,27";"126.545,11";""
"05.04.2024";"05.04.2024";"DK  3257668 108645125850 03.04";"";"3.423,00";"129.968,11";""
"05.04.2024";"05.04.2024";"DK  3257668 108645125950 04.04";"";"3.864,00";"133.832,11";""
"05.04.2024";"05.04.2024";"LS 46868 THAI FRESH IMPORT/EKSPORT";"";"-9.112,50";"124.719,61";""
"05.04.2024";"05.04.2024";"Mealo: 18284                        -SE MEDD.";"";"22.632,55";"147.352,16";""
"05.04.2024";"05.04.2024";"AB Tingstad Papper                  -SE MEDD.";"";"-7.638,00";"139.714,16";""
"08.04.2024";"08.04.2024";"VD 00018 INCO CC GLOSTRUP A/S";"";"307,86";"140.022,02";""
"08.04.2024";"08.04.2024";"DK  3257668 108645126150 05.04";"";"3.884,00";"143.906,02";""
"08.04.2024";"08.04.2024";"DK  3257668 409620800000 05.04";"";"892,00";"144.798,02";""
"08.04.2024";"08.04.2024";"DK  3257668 108645126350 06.04";"";"2.876,00";"147.674,02";""
"08.04.2024";"08.04.2024";"DK  3257668 108645126550 07.04";"";"835,00";"148.509,02";""
"08.04.2024";"08.04.2024";"DK  3257668 409720800000 06.04";"";"959,00";"149.468,02";""
"08.04.2024";"08.04.2024";"DK  3257668 409820800000 07.04";"";"2.583,00";"152.051,02";""
"09.04.2024";"09.04.2024";"Overførsel                          -SE MEDD.";"";"8.747,90";"160.798,92";""
"09.04.2024";"09.04.2024";"Nets 0098 8822884                   -SE MEDD.";"";"2.883,22";"163.682,14";""
"09.04.2024";"09.04.2024";"Nets 0099 8822884                   -SE MEDD.";"";"6.566,44";"170.248,58";""
"10.04.2024";"10.04.2024";"Nets 0100 8822884                   -SE MEDD.";"";"6.310,10";"176.558,68";""
"10.04.2024";"10.04.2024";"DK  3257668 108645126850 09.04";"";"2.996,00";"179.554,68";""
"10.04.2024";"10.04.2024";"DK  3257668 410020800000 09.04";"";"700,00";"180.254,68";""
"10.04.2024";"10.04.2024";"A-skat";"";"-41.507,00";"138.747,68";""
"11.04.2024";"11.04.2024";"Afdrag lån Jarvinen";"";"-10.000,00";"128.747,68";""
"11.04.2024";"11.04.2024";"Nets 0101 8822884                   -SE MEDD.";"";"1.870,81";"130.618,49";""
"11.04.2024";"11.04.2024";"DK  3257668 108645127050 10.04";"";"4.630,00";"135.248,49";""
"11.04.2024";"11.04.2024";"LS 46868 THAI FRESH IMPORT/EKSPORT";"";"-2.562,50";"132.685,99";""
"11.04.2024";"11.04.2024";"VD 00019 INCO CC GLOSTRUP A/S";"";"-4.084,28";"128.601,71";""
"12.04.2024";"12.04.2024";"Samlet Betaling 4.kvt 2023";"";"-3.204,25";"125.397,46";""
"12.04.2024";"12.04.2024";"DK  3257668 108645127250 11.04";"";"4.812,00";"130.209,46";""
"12.04.2024";"12.04.2024";"DK  3257668 410220800000 11.04";"";"965,00";"131.174,46";""
"12.04.2024";"12.04.2024";"Nets 0102 8822884                   -SE MEDD.";"";"4.592,46";"135.766,92";""
"12.04.2024";"12.04.2024";"Overførsel                          -SE MEDD.";"";"11.425,10";"147.192,02";""
"12.04.2024";"12.04.2024";"Faktura 46                          -SE MEDD.";"";"6.093,75";"153.285,77";""
"12.04.2024";"12.04.2024";"Mealo: 18455                        -SE MEDD.";"";"22.050,56";"175.336,33";""
"12.04.2024";"12.04.2024";"Feriepenge";"";"-9.138,44";"166.197,89";""
"12.04.2024";"12.04.2024";"VD 00020 INCO CC KOEBENHAVN A/S";"";"-388,71";"165.809,18";""
"12.04.2024";"12.04.2024";"VD 00008 CATERINGINVENTAR.DK";"";"-2.620,63";"163.188,55";""
"15.04.2024";"15.04.2024";"VD 00021 INCO CC GLOSTRUP A/S";"";"-6.793,83";"156.394,72";""
"15.04.2024";"15.04.2024";"Kosan Gas";"";"-1.498,76";"154.895,96";""
"15.04.2024";"15.04.2024";"DK  3257668 108645127450 12.04";"";"4.060,00";"158.955,96";""
"15.04.2024";"15.04.2024";"LS 41033 ESMILEY A/S";"";"-1.236,38";"157.719,58";""
"15.04.2024";"15.04.2024";"LS 46868 THAI FRESH IMPORT/EKSPORT";"";"-7.710,50";"150.009,08";""
"15.04.2024";"15.04.2024";"DK  3257668 108645127650 13.04";"";"4.156,00";"154.165,08";""
"15.04.2024";"15.04.2024";"DK  3257668 108645127750 14.04";"";"2.898,50";"157.063,58";""
"15.04.2024";"15.04.2024";"DK  3257668 410420800000 13.04";"";"522,00";"157.585,58";""
"16.04.2024";"16.04.2024";"Nets 0103 8822884                   -SE MEDD.";"";"4.663,89";"162.249,47";""
"16.04.2024";"16.04.2024";"Nets 0104 8822884                   -SE MEDD.";"";"4.641,17";"166.890,64";""
"16.04.2024";"16.04.2024";"e-conomic 2q2024";"";"-933,75";"165.956,89";""
"17.04.2024";"17.04.2024";"Brøndbyvester VVS toilet";"";"-3.023,44";"162.933,45";""
"17.04.2024";"17.04.2024";"Nets 0105 8822884                   -SE MEDD.";"";"6.802,20";"169.735,65";""
"17.04.2024";"17.04.2024";"Overførsel                          -SE MEDD.";"";"14.094,65";"183.830,30";""
"17.04.2024";"17.04.2024";"DK  3257668 108645128050 16.04";"";"4.749,00";"188.579,30";""
"17.04.2024";"17.04.2024";"DK  3257668 410720800000 16.04";"";"1.152,00";"189.731,30";""
"18.04.2024";"18.04.2024";"Nets 0106 8822884                   -SE MEDD.";"";"3.590,58";"193.321,88";""
"18.04.2024";"18.04.2024";"DK  3257668 108645128250 17.04";"";"4.508,00";"197.829,88";""
"18.04.2024";"18.04.2024";"DK  3257668 410820800000 17.04";"";"1.026,00";"198.855,88";""
"18.04.2024";"18.04.2024";"LS 44733 DERMAN PACK APS";"";"-2.270,00";"196.585,88";""
"18.04.2024";"18.04.2024";"LS 46868 THAI FRESH IMPORT/EKSPORT";"";"-3.539,63";"193.046,25";""
"18.04.2024";"18.04.2024";"VD 00022 INCO CC GLOSTRUP A/S";"";"-4.884,20";"188.162,05";""
"19.04.2024";"19.04.2024";"KPA Company plastbøtter";"";"-1.611,04";"186.551,01";""
"19.04.2024";"19.04.2024";"DK  3257668 108645128450 18.04";"";"1.084,00";"187.635,01";""
"19.04.2024";"19.04.2024";"DK  3257668 410920800000 18.04";"";"826,00";"188.461,01";""
"19.04.2024";"19.04.2024";"Nets 0107 8822884                   -SE MEDD.";"";"4.104,11";"192.565,12";""
"19.04.2024";"19.04.2024";"Mealo: 18629                        -SE MEDD.";"";"26.612,83";"219.177,95";""
"19.04.2024";"19.04.2024";"VD 00023 JOHANNESFOG A/S";"";"-811,00";"218.366,95";""
"22.04.2024";"22.04.2024";"VD 00024 INCO CC GLOSTRUP A/S";"";"-4.734,61";"213.632,34";""
"22.04.2024";"22.04.2024";"DK  3257668 108645128650 19.04";"";"5.471,00";"219.103,34";""
"22.04.2024";"22.04.2024";"DK  3257668 411020800000 19.04";"";"2.363,00";"221.466,34";""
"22.04.2024";"22.04.2024";"LS 46868 THAI FRESH IMPORT/EKSPORT";"";"-8.262,50";"213.203,84";""
"22.04.2024";"22.04.2024";"DK  3257668 108645128850 20.04";"";"5.865,00";"219.068,84";""
"22.04.2024";"22.04.2024";"DK  3257668 108645129050 21.04";"";"4.580,00";"223.648,84";""
"22.04.2024";"22.04.2024";"DK  3257668 411220800000 21.04";"";"705,00";"224.353,84";""
"23.04.2024";"23.04.2024";"Nets 0108 8822884                   -SE MEDD.";"";"4.133,96";"228.487,80";""
"23.04.2024";"23.04.2024";"Nets 0109 8822884                   -SE MEDD.";"";"6.137,30";"234.625,10";""
"24.04.2024";"24.04.2024";"Overførsel                          -SE MEDD.";"";"12.547,35";"247.172,45";""
"24.04.2024";"24.04.2024";"Nets 0110 8822884                   -SE MEDD.";"";"6.508,12";"253.680,57";""
"24.04.2024";"24.04.2024";"75-101-3-4 Tilgodeha                -SE MEDD.";"";"36.293,92";"289.974,49";""
"24.04.2024";"24.04.2024";"LS 21865 CARLSBERG DANMARK A/S";"";"-3.517,36";"286.457,13";""
"24.04.2024";"24.04.2024";"DK  3257668 108645129350 23.04";"";"5.082,00";"291.539,13";""
"24.04.2024";"24.04.2024";"LS 46868 THAI FRESH IMPORT/EKSPORT";"";"-3.378,00";"288.161,13";""
"25.04.2024";"25.04.2024";"DK  3257668 108645129550 24.04";"";"3.759,00";"291.920,13";""
"25.04.2024";"25.04.2024";"DK  3257668 411520800000 24.04";"";"471,00";"292.391,13";""
"25.04.2024";"25.04.2024";"Nets 0111 8822884                   -SE MEDD.";"";"3.409,24";"295.800,37";""
"25.04.2024";"25.04.2024";"VD 00025 Elgiganten Taastrup";"";"-3.299,00";"292.501,37";""
"26.04.2024";"26.04.2024";"BS VERISURE A/S";"";"-461,00";"292.040,37";""
"26.04.2024";"26.04.2024";"DK  3257668 108645129750 25.04";"";"2.708,00";"294.748,37";""
"26.04.2024";"26.04.2024";"DK  3257668 411620800000 25.04";"";"532,00";"295.280,37";""
"26.04.2024";"26.04.2024";"LS 46868 THAI FRESH IMPORT/EKSPORT";"";"-1.652,50";"293.627,87";""
"26.04.2024";"26.04.2024";"Nets 0112 8822884                   -SE MEDD.";"";"2.944,66";"296.572,53";""
"26.04.2024";"26.04.2024";"Mealo: 18806                        -SE MEDD.";"";"18.858,61";"315.431,14";""
"26.04.2024";"26.04.2024";"VD 00027 JEM & FIX, TAASTRUP";"";"-167,32";"315.263,82";""
"26.04.2024";"26.04.2024";"VD 00026 INCO CC GLOSTRUP A/S";"";"-7.692,93";"307.570,89";""
"29.04.2024";"29.04.2024";"Overførsel                          -SE MEDD.";"";"8.385,60";"315.956,49";""
"29.04.2024";"29.04.2024";"VD 00029 INCO CC GLOSTRUP A/S";"";"592,61";"316.549,10";""
"29.04.2024";"29.04.2024";"VD 00028 HUMAC FREDERIKSBERG CENTR";"";"-18.530,97";"298.018,13";""
"29.04.2024";"29.04.2024";"DK  3257668 108645129950 26.04";"";"4.995,70";"303.013,83";""
"29.04.2024";"29.04.2024";"DK  3257668 411720800000 26.04";"";"1.450,00";"304.463,83";""
"29.04.2024";"29.04.2024";"LS 46868 THAI FRESH IMPORT/EKSPORT";"";"-6.520,00";"297.943,83";""
"29.04.2024";"29.04.2024";"Wolt Danmark DRIVE";"";"-3.166,25";"294.777,58";""
"29.04.2024";"29.04.2024";"DK  3257668 108645130150 27.04";"";"3.544,00";"298.321,58";""
"29.04.2024";"29.04.2024";"DK  3257668 108645130350 28.04";"";"2.444,00";"300.765,58";""
"29.04.2024";"29.04.2024";"DK  3257668 411820800000 27.04";"";"2.018,30";"302.783,88";""
"29.04.2024";"29.04.2024";"DK  3257668 411920800000 28.04";"";"536,00";"303.319,88";""
"29.04.2024";"29.04.2024";"VD 00031 KFT JYLLAND-KBH";"";"-399,56";"302.920,32";""
"29.04.2024";"29.04.2024";"VD 00030 INCO CC KOEBENHAVN A/S";"";"-4.598,71";"298.321,61";""
"29.04.2024";"29.04.2024";"Løn";"";"-93.376,94";"204.944,67";""
"29.04.2024";"29.04.2024";"Overførsel";"";"-240,10";"204.704,57";""
"30.04.2024";"30.04.2024";"Omkostninger, Netbank og Mobilbank";"";"-4,00";"204.700,57";""
"30.04.2024";"30.04.2024";"Nets 0113 8822884                   -SE MEDD.";"";"2.761,83";"207.462,40";""
"30.04.2024";"30.04.2024";"Nets 0114 8822884                   -SE MEDD.";"";"5.097,04";"212.559,44";""
"30.04.2024";"30.04.2024";"Fra Tania Damsgaard                 -SE MEDD.";"";"250,00";"212.809,44";""
"01.05.2024";"01.05.2024";"Nets 0115 8822884                   -SE MEDD.";"";"12.202,04";"225.011,48";""
"01.05.2024";"01.05.2024";"BS REMONDIS A/S";"";"-3.127,95";"221.883,53";""
"01.05.2024";"01.05.2024";"BS ONLINEPOS APS";"";"-2.061,25";"219.822,28";""
"01.05.2024";"01.05.2024";"BS EJD. 643 TAASTRUP HOVEDGADE 64";"";"-36.389,19";"183.433,09";""
"01.05.2024";"01.05.2024";"DK  3257668 108645130650 30.04";"";"12.467,80";"195.900,89";""
"01.05.2024";"01.05.2024";"NRGi elregning marts";"";"-11.104,82";"184.796,07";""
"01.05.2024";"01.05.2024";"Deopsitum Thai Festival";"";"-1.000,00";"183.796,07";""
"01.05.2024";"01.05.2024";"VD 00032 INCO CC GLOSTRUP A/S";"";"-3.430,81";"180.365,26";""
"02.05.2024";"02.05.2024";"Nets 0116 8822884                   -SE MEDD.";"";"2.223,32";"182.588,58";""
"02.05.2024";"02.05.2024";"Overførsel                          -SE MEDD.";"";"14.631,65";"197.220,23";""
"02.05.2024";"02.05.2024";"DK  3257668 108645130850 01.05";"";"3.170,00";"200.390,23";""
"02.05.2024";"02.05.2024";"DK  3257668 412220800000 01.05";"";"507,00";"200.897,23";""
"02.05.2024";"02.05.2024";"LS 46868 THAI FRESH IMPORT/EKSPORT";"";"-4.346,50";"196.550,73";""
"02.05.2024";"02.05.2024";"Ordre 442 Henriette                 -SE MEDD.";"";"6.319,00";"202.869,73";""
"02.05.2024";"02.05.2024";"Ordre #441 - Ishøj                  -SE MEDD.";"";"8.496,00";"211.365,73";""
"03.05.2024";"03.05.2024";"Nets 0117 8822884                   -SE MEDD.";"";"3.418,18";"214.783,91";""
"03.05.2024";"03.05.2024";"DK  3257668 108645131050 02.05";"";"1.453,00";"216.236,91";""
"03.05.2024";"03.05.2024";"DK  3257668 412320800000 02.05";"";"2.674,00";"218.910,91";""
"03.05.2024";"03.05.2024";"Mealo: 18990                        -SE MEDD.";"";"26.999,29";"245.910,20";""
"06.05.2024";"06.05.2024";"VD 00033 INCO CC GLOSTRUP A/S";"";"-5.192,28";"240.717,92";""
"06.05.2024";"06.05.2024";"DK  3257668 108645131250 03.05";"";"4.931,00";"245.648,92";""
"06.05.2024";"06.05.2024";"DK  3257668 412420800000 03.05";"";"2.547,00";"248.195,92";""
"06.05.2024";"06.05.2024";"LS 46868 THAI FRESH IMPORT/EKSPORT";"";"-9.212,50";"238.983,42";""
"06.05.2024";"06.05.2024";"LS 47422 DAKA DENMARK A/S";"";"-973,93";"238.009,49";""
"06.05.2024";"06.05.2024";"DK  3257668 108645131450 04.05";"";"4.773,60";"242.783,09";""
"06.05.2024";"06.05.2024";"DK  3257668 108645131650 05.05";"";"3.934,00";"246.717,09";""
"06.05.2024";"06.05.2024";"DK  3257668 412520800000 04.05";"";"733,00";"247.450,09";""
"06.05.2024";"06.05.2024";"DK  3257668 412620800000 05.05";"";"1.341,00";"248.791,09";""
"07.05.2024";"07.05.2024";"Nets 0118 8822884                   -SE MEDD.";"";"2.940,27";"251.731,36";""
"07.05.2024";"07.05.2024";"Nets 0119 8822884                   -SE MEDD.";"";"6.643,01";"258.374,37";""
"07.05.2024";"07.05.2024";"Overførsel                          -SE MEDD.";"";"13.882,85";"272.257,22";""
"07.05.2024";"07.05.2024";"PBS DK Abon 3257668 010424-300424";"";"-540,72";"271.716,50";""
"08.05.2024";"08.05.2024";"DK  3257668 108645131850 07.05";"";"2.866,00";"274.582,50";""
"08.05.2024";"08.05.2024";"DK  3257668 412820800000 07.05";"";"455,00";"275.037,50";""
"08.05.2024";"08.05.2024";"Nets 0120 8822884                   -SE MEDD.";"";"9.013,24";"284.050,74";""
"08.05.2024";"08.05.2024";"VD 00034 INCO CC GLOSTRUP A/S";"";"-5.305,28";"278.745,46";""
"08.05.2024";"08.05.2024";"Udlæg LG Barwaan";"";"-3.404,00";"275.341,46";""
"13.05.2024";"13.05.2024";"VD 00035 INCO CC GLOSTRUP A/S";"";"-3.645,46";"271.696,00";""
"13.05.2024";"13.05.2024";"VD 00036 COOP KVICKLY TAASTRUP";"";"-478,05";"271.217,95";""
"13.05.2024";"13.05.2024";"Afdrag lån Jarvinen";"";"-10.000,00";"261.217,95";""
"13.05.2024";"13.05.2024";"Til KFT Jylland ApS";"";"-18.240,30";"242.977,65";""
"13.05.2024";"13.05.2024";"DK  3257668 108645132050 08.05";"";"4.750,20";"247.727,85";""
"13.05.2024";"13.05.2024";"DK  3257668 412920800000 08.05";"";"789,00";"248.516,85";""
"13.05.2024";"13.05.2024";"LS 46868 THAI FRESH IMPORT/EKSPORT";"";"-6.031,00";"242.485,85";""
"13.05.2024";"13.05.2024";"Telefon Telenor";"";"-378,38";"242.107,47";""
"13.05.2024";"13.05.2024";"LaserTryk";"";"-1.114,75";"240.992,72";""
"13.05.2024";"13.05.2024";"DK  3257668 108645132250 09.05";"";"3.651,00";"244.643,72";""
"13.05.2024";"13.05.2024";"DK  3257668 108645132450 10.05";"";"3.658,00";"248.301,72";""
"13.05.2024";"13.05.2024";"DK  3257668 108645132650 11.05";"";"1.047,00";"249.348,72";""
"13.05.2024";"13.05.2024";"DK  3257668 108645132850 12.05";"";"4.335,34";"253.684,06";""
"13.05.2024";"13.05.2024";"DK  3257668 413120800000 10.05";"";"1.228,00";"254.912,06";""
"13.05.2024";"13.05.2024";"DK  3257668 413220800000 11.05";"";"997,00";"255.909,06";""
"13.05.2024";"13.05.2024";"Mealo: 19179                        -SE MEDD.";"";"21.266,37";"277.175,43";""
"13.05.2024";"13.05.2024";"A-skat";"";"-42.493,00";"234.682,43";""
"14.05.2024";"14.05.2024";"Nets 0121 8822884                   -SE MEDD.";"";"2.590,74";"237.273,17";""
"14.05.2024";"14.05.2024";"Nets 0122 8822884                   -SE MEDD.";"";"2.772,17";"240.045,34";""
"14.05.2024";"14.05.2024";"Overførsel                          -SE MEDD.";"";"14.766,35";"254.811,69";""
"14.05.2024";"14.05.2024";"Feriepenge";"";"-9.280,52";"245.531,17";""
"14.05.2024";"14.05.2024";"Leje af stadeplads 8.juni";"";"-5.000,00";"240.531,17";""
"15.05.2024";"15.05.2024";"Nets 0123 8822884                   -SE MEDD.";"";"15.493,61";"256.024,78";""
"15.05.2024";"15.05.2024";"LS 21865 CARLSBERG DANMARK A/S";"";"-6.779,95";"249.244,83";""
"15.05.2024";"15.05.2024";"DK  3257668 108645133150 14.05";"";"2.695,00";"251.939,83";""
"15.05.2024";"15.05.2024";"LS 46868 THAI FRESH IMPORT/EKSPORT";"";"-5.163,75";"246.776,08";""
"16.05.2024";"16.05.2024";"DK  3257668 108645133350 15.05";"";"2.799,00";"249.575,08";""
"16.05.2024";"16.05.2024";"DK  3257668 413620800000 15.05";"";"940,00";"250.515,08";""
"16.05.2024";"16.05.2024";"LS 46868 THAI FRESH IMPORT/EKSPORT";"";"-6.321,50";"244.193,58";""
"16.05.2024";"16.05.2024";"Nets 0124 8822884                   -SE MEDD.";"";"826,17";"245.019,75";""
"16.05.2024";"16.05.2024";"Til Vision Watercare Servicebilen";"";"-1.237,00";"243.782,75";""
"16.05.2024";"16.05.2024";"VD 00037 INCO CC GLOSTRUP A/S";"";"-5.044,13";"238.738,62";""
"17.05.2024";"17.05.2024";"Nets 0125 8822884                   -SE MEDD.";"";"6.613,83";"245.352,45";""
"17.05.2024";"17.05.2024";"Overførsel                          -SE MEDD.";"";"11.418,30";"256.770,75";""
"17.05.2024";"17.05.2024";"DK  3257668 108645133550 16.05";"";"3.493,00";"260.263,75";""
"17.05.2024";"17.05.2024";"DK  3257668 413720800000 16.05";"";"456,00";"260.719,75";""
"17.05.2024";"17.05.2024";"AB Tingstad Papper                  -SE MEDD.";"";"-6.073,00";"254.646,75";""
"17.05.2024";"17.05.2024";"Mealo: 19362                        -SE MEDD.";"";"20.119,69";"274.766,44";""
"21.05.2024";"21.05.2024";"VD 00038 INCO CC GLOSTRUP A/S";"";"-414,90";"274.351,54";""
"21.05.2024";"21.05.2024";"VD 00039 KFT JYLLAND-KBH";"";"-1.598,45";"272.753,09";""
"21.05.2024";"21.05.2024";"VD 00040 INCO CC GLOSTRUP A/S";"";"-2.138,01";"270.615,08";""
"21.05.2024";"21.05.2024";"DK  3257668 108645133750 17.05";"";"3.297,00";"273.912,08";""
"21.05.2024";"21.05.2024";"DK  3257668 413820800000 17.05";"";"218,00";"274.130,08";""
"21.05.2024";"21.05.2024";"LS 46868 THAI FRESH IMPORT/EKSPORT";"";"-5.683,13";"268.446,95";""
"21.05.2024";"21.05.2024";"DK  3257668 108645133950 18.05";"";"3.981,00";"272.427,95";""
"21.05.2024";"21.05.2024";"DK  3257668 108645134150 19.05";"";"2.749,00";"275.176,95";""
"21.05.2024";"21.05.2024";"DK  3257668 413920800000 18.05";"";"761,00";"275.937,95";""
"21.05.2024";"21.05.2024";"Kosan Gas";"";"-1.498,76";"274.439,19";""
"22.05.2024";"22.05.2024";"Nets 0126 8822884                   -SE MEDD.";"";"4.620,59";"279.059,78";""
"22.05.2024";"22.05.2024";"Nets 0127 8822884                   -SE MEDD.";"";"3.695,88";"282.755,66";""
"22.05.2024";"22.05.2024";"Overførsel                          -SE MEDD.";"";"8.911,50";"291.667,16";""
"22.05.2024";"22.05.2024";"DK  3257668 108645134450 21.05";"";"4.999,00";"296.666,16";""
"22.05.2024";"22.05.2024";"DK  3257668 414220800000 21.05";"";"2.013,20";"298.679,36";""
"23.05.2024";"23.05.2024";"Nets 0128 8822884                   -SE MEDD.";"";"6.572,80";"305.252,16";""
"23.05.2024";"23.05.2024";"DK  3257668 108645134650 22.05";"";"1.664,00";"306.916,16";""
"23.05.2024";"23.05.2024";"DK  3257668 414320800000 22.05";"";"371,00";"307.287,16";""
"23.05.2024";"23.05.2024";"LS 46868 THAI FRESH IMPORT/EKSPORT";"";"-5.874,38";"301.412,78";""
"24.05.2024";"24.05.2024";"DK  3257668 108645134850 23.05";"";"1.132,00";"302.544,78";""
"24.05.2024";"24.05.2024";"Nets 0129 8822884                   -SE MEDD.";"";"2.444,97";"304.989,75";""
"24.05.2024";"24.05.2024";"Mealo: 19548                        -SE MEDD.";"";"21.135,23";"326.124,98";""
"27.05.2024";"27.05.2024";"VD 00041 INCO CC GLOSTRUP A/S";"";"-5.034,53";"321.090,45";""
"27.05.2024";"27.05.2024";"VD 00043 NORMAL TAASTRUP HOVEDGADE";"";"-50,00";"321.040,45";""
"27.05.2024";"27.05.2024";"VD 00042 HARALD NYBORG ISHOEJ";"";"-321,00";"320.719,45";""
"27.05.2024";"27.05.2024";"DK  3257668 108645135050 24.05";"";"1.726,00";"322.445,45";""
"27.05.2024";"27.05.2024";"LS 46868 THAI FRESH IMPORT/EKSPORT";"";"-7.206,75";"315.238,70";""
"27.05.2024";"27.05.2024";"DK  3257668 108645135250 25.05";"";"6.912,70";"322.151,40";""
"27.05.2024";"27.05.2024";"DK  3257668 108645135450 26.05";"";"3.328,00";"325.479,40";""
"28.05.2024";"28.05.2024";"Overførsel                          -SE MEDD.";"";"12.161,65";"337.641,05";""
"28.05.2024";"28.05.2024";"Nets 0130 8822884                   -SE MEDD.";"";"2.495,71";"340.136,76";""
"28.05.2024";"28.05.2024";"Nets 0131 8822884                   -SE MEDD.";"";"3.994,50";"344.131,26";""
"29.05.2024";"29.05.2024";"Wolt Danmark DRIVE";"";"-2.793,75";"341.337,51";""
"29.05.2024";"29.05.2024";"Nets 0132 8822884                   -SE MEDD.";"";"5.504,52";"346.842,03";""
"29.05.2024";"29.05.2024";"BS VERISURE A/S";"";"-461,00";"346.381,03";""
"29.05.2024";"29.05.2024";"DK  3257668 108645135750 28.05";"";"3.265,00";"349.646,03";""
"29.05.2024";"29.05.2024";"NETS Faktura 604473497";"";"-1.153,64";"348.492,39";""
"30.05.2024";"30.05.2024";"DK  3257668 108645135950 29.05";"";"1.206,00";"349.698,39";""
"30.05.2024";"30.05.2024";"LS 44733 DERMAN PACK APS";"";"-2.923,73";"346.774,66";""
"30.05.2024";"30.05.2024";"LS 46868 THAI FRESH IMPORT/EKSPORT";"";"-2.118,75";"344.655,91";""
"30.05.2024";"30.05.2024";"Nets 0133 8822884                   -SE MEDD.";"";"3.912,66";"348.568,57";""
"30.05.2024";"30.05.2024";"VD 00044 INCO CC GLOSTRUP A/S";"";"-5.042,20";"343.526,37";""
"30.05.2024";"30.05.2024";"Løn";"";"-102.662,23";"240.864,14";""
"30.05.2024";"30.05.2024";"Overførsel";"";"-240,10";"240.624,04";""
"31.05.2024";"31.05.2024";"DK  3257668 108645136150 30.05";"";"1.075,00";"241.699,04";""
"31.05.2024";"31.05.2024";"DK  3257668 415120800000 30.05";"";"1.072,00";"242.771,04";""
"31.05.2024";"31.05.2024";"Nets 0134 8822884                   -SE MEDD.";"";"4.590,02";"247.361,06";""
"31.05.2024";"31.05.2024";"Fra Tania Damsgaard                 -SE MEDD.";"";"250,00";"247.611,06";""
"31.05.2024";"31.05.2024";"Mealo: 19736                        -SE MEDD.";"";"19.277,59";"266.888,65";""
"03.06.2024";"03.06.2024";"VD 00045 INCO CC GLOSTRUP A/S";"";"-2.706,16";"264.182,49";""
"03.06.2024";"03.06.2024";"BS REMONDIS A/S";"";"-4.064,60";"260.117,89";""
"03.06.2024";"03.06.2024";"BS ONLINEPOS APS";"";"-2.061,25";"258.056,64";""
"03.06.2024";"03.06.2024";"BS NRGI ELHANDEL A/S";"";"-9.950,21";"248.106,43";""
"03.06.2024";"03.06.2024";"BS EJD. 643 TAASTRUP HOVEDGADE 64";"";"-38.737,12";"209.369,31";""
"03.06.2024";"03.06.2024";"DK  3257668 108645136350 31.05";"";"3.691,00";"213.060,31";""
"03.06.2024";"03.06.2024";"DK  3257668 415220800000 31.05";"";"1.433,00";"214.493,31";""
"03.06.2024";"03.06.2024";"LS 46868 THAI FRESH IMPORT/EKSPORT";"";"-6.332,50";"208.160,81";""
"03.06.2024";"03.06.2024";"DK  3257668 108645136550 01.06";"";"10.037,00";"218.197,81";""
"03.06.2024";"03.06.2024";"DK  3257668 108645136750 02.06";"";"500,00";"218.697,81";""
"03.06.2024";"03.06.2024";"DK  3257668 415320800000 01.06";"";"2.411,00";"221.108,81";""
"03.06.2024";"03.06.2024";"DK  3257668 415420800000 02.06";"";"1.491,00";"222.599,81";""
"03.06.2024";"03.06.2024";"VD 00046 THAI AIRWAYS";"";"-22.889,00";"199.710,81";""
"04.06.2024";"04.06.2024";"Overførsel                          -SE MEDD.";"";"10.397,30";"210.108,11";""
"04.06.2024";"04.06.2024";"Nets 0135 8822884                   -SE MEDD.";"";"3.252,48";"213.360,59";""
"04.06.2024";"04.06.2024";"Nets 0136 8822884                   -SE MEDD.";"";"3.442,74";"216.803,33";""
"04.06.2024";"04.06.2024";"LS 47422 DAKA DENMARK A/S";"";"-719,55";"216.083,78";""
"04.06.2024";"04.06.2024";"VD 00047 Team Hvidevarer ApS";"";"-9.198,00";"206.885,78";""
"06.06.2024";"06.06.2024";"PBS DK Abon 3257668 010524-310524";"";"-473,02";"206.412,76";""
"06.06.2024";"06.06.2024";"DK  3257668 108645137050 04.06";"";"2.644,00";"209.056,76";""
"06.06.2024";"06.06.2024";"DK  3257668 415620800000 04.06";"";"2.244,00";"211.300,76";""
"06.06.2024";"06.06.2024";"LS 46868 THAI FRESH IMPORT/EKSPORT";"";"-3.530,00";"207.770,76";""
"06.06.2024";"06.06.2024";"DK  3257668 108645137250 05.06";"";"3.822,00";"211.592,76";""
"06.06.2024";"06.06.2024";"DK  3257668 415720800000 05.06";"";"1.980,00";"213.572,76";""
"06.06.2024";"06.06.2024";"VD 00048 INCO CC GLOSTRUP A/S";"";"-4.548,41";"209.024,35";""
"07.06.2024";"07.06.2024";"Nets 0137 8822884                   -SE MEDD.";"";"8.291,28";"217.315,63";""
"07.06.2024";"07.06.2024";"Nets 0138 8822884                   -SE MEDD.";"";"5.106,17";"222.421,80";""
"07.06.2024";"07.06.2024";"Overførsel                          -SE MEDD.";"";"15.495,30";"237.917,10";""
"07.06.2024";"07.06.2024";"DK  3257668 108645137450 06.06";"";"3.501,00";"241.418,10";""
"07.06.2024";"07.06.2024";"DK  3257668 415820800000 06.06";"";"547,00";"241.965,10";""
"07.06.2024";"07.06.2024";"Mealo: 19933                        -SE MEDD.";"";"25.165,61";"267.130,71";""
"07.06.2024";"07.06.2024";"VD 00049 COOP365 TAASTRUP";"";"-84,60";"267.046,11";""
"10.06.2024";"10.06.2024";"VD 00050 INCO CC GLOSTRUP A/S";"";"-3.685,38";"263.360,73";""
"10.06.2024";"10.06.2024";"DK  3257668 108645137650 07.06";"";"4.850,00";"268.210,73";""
"10.06.2024";"10.06.2024";"DK  3257668 415920800000 07.06";"";"1.018,00";"269.228,73";""
"10.06.2024";"10.06.2024";"LS 46868 THAI FRESH IMPORT/EKSPORT";"";"-3.385,00";"265.843,73";""
"10.06.2024";"10.06.2024";"DK  3257668 108645137950 09.06";"";"2.180,00";"268.023,73";""
"10.06.2024";"10.06.2024";"DK  3257668 416120800000 09.06";"";"509,00";"268.532,73";""
"10.06.2024";"10.06.2024";"A-skat";"";"-41.584,00";"226.948,73";""
"11.06.2024";"11.06.2024";"Afdrag lån Jarvinen";"";"-10.000,00";"216.948,73";""
"11.06.2024";"11.06.2024";"Nets 0139 8822884                   -SE MEDD.";"";"10.254,95";"227.203,68";""
"11.06.2024";"11.06.2024";"Nets 0140 8822884                   -SE MEDD.";"";"5.620,19";"232.823,87";""
"12.06.2024";"12.06.2024";"Nets 0141 8822884                   -SE MEDD.";"";"3.175,22";"235.999,09";""
"12.06.2024";"12.06.2024";"Overførsel                          -SE MEDD.";"";"12.346,10";"248.345,19";""
"12.06.2024";"12.06.2024";"LS 21865 CARLSBERG DANMARK A/S";"";"-8.150,14";"240.195,05";""
"12.06.2024";"12.06.2024";"DK  3257668 108645138250 11.06";"";"3.242,00";"243.437,05";""
"12.06.2024";"12.06.2024";"DK  3257668 416320800000 11.06";"";"545,00";"243.982,05";""
"12.06.2024";"12.06.2024";"VD 00051 INCO CC GLOSTRUP A/S";"";"-4.435,91";"239.546,14";""
"13.06.2024";"13.06.2024";"DK  3257668 108645138450 12.06";"";"1.906,00";"241.452,14";""
"13.06.2024";"13.06.2024";"LS 46868 THAI FRESH IMPORT/EKSPORT";"";"-6.336,00";"235.116,14";""
"13.06.2024";"13.06.2024";"Nets 0142 8822884                   -SE MEDD.";"";"3.628,70";"238.744,84";""
"13.06.2024";"13.06.2024";"Feriepenge";"";"-9.189,56";"229.555,28";""
"14.06.2024";"14.06.2024";"DK  3257668 108645138650 13.06";"";"1.453,00";"231.008,28";""
"14.06.2024";"14.06.2024";"DK  3257668 416520800000 13.06";"";"506,00";"231.514,28";""
"14.06.2024";"14.06.2024";"Nets 0143 8822884                   -SE MEDD.";"";"4.649,62";"236.163,90";""
"14.06.2024";"14.06.2024";"Mealo: 20133                        -SE MEDD.";"";"20.189,88";"256.353,78";""
"17.06.2024";"17.06.2024";"VD 00052 INCO CC GLOSTRUP A/S";"";"-3.408,39";"252.945,39";""
"17.06.2024";"17.06.2024";"DK  3257668 108645138850 14.06";"";"3.995,00";"256.940,39";""
"17.06.2024";"17.06.2024";"LS 46868 THAI FRESH IMPORT/EKSPORT";"";"-6.177,50";"250.762,89";""
"17.06.2024";"17.06.2024";"Kosan Gas";"";"-1.498,76";"249.264,13";""
"17.06.2024";"17.06.2024";"Telenor 240002402904";"";"-857,98";"248.406,15";""
"17.06.2024";"17.06.2024";"DK  3257668 108645139050 15.06";"";"2.943,00";"251.349,15";""
"17.06.2024";"17.06.2024";"DK  3257668 108645139250 16.06";"";"1.297,00";"252.646,15";""
"17.06.2024";"17.06.2024";"DK  3257668 416720800000 15.06";"";"1.176,00";"253.822,15";""
"17.06.2024";"17.06.2024";"VD 00053 INCO CC GLOSTRUP A/S";"";"-2.824,56";"250.997,59";""
"18.06.2024";"18.06.2024";"Overførsel                          -SE MEDD.";"";"16.088,15";"267.085,74";""
"18.06.2024";"18.06.2024";"Nets 0144 8822884                   -SE MEDD.";"";"8.544,80";"275.630,54";""
"18.06.2024";"18.06.2024";"Nets 0145 8822884                   -SE MEDD.";"";"4.099,60";"279.730,14";""
"19.06.2024";"19.06.2024";"Nets 0146 8822884                   -SE MEDD.";"";"2.908,89";"282.639,03";""
"19.06.2024";"19.06.2024";"LS 21865 CARLSBERG DANMARK A/S";"";"-1.777,04";"280.861,99";""
"19.06.2024";"19.06.2024";"DK  3257668 108645139550 18.06";"";"2.752,00";"283.613,99";""
"19.06.2024";"19.06.2024";"VD 00055 JEM & FIX, TAASTRUP";"";"-361,21";"283.252,78";""
"19.06.2024";"19.06.2024";"VD 00054 INCO CC GLOSTRUP A/S";"";"-3.995,98";"279.256,80";""
"20.06.2024";"20.06.2024";"DK  3257668 108645139750 19.06";"";"2.120,90";"281.377,70";""
"20.06.2024";"20.06.2024";"DK  3257668 417120800000 19.06";"";"2.086,00";"283.463,70";""
"20.06.2024";"20.06.2024";"LS 46868 THAI FRESH IMPORT/EKSPORT";"";"-6.080,50";"277.383,20";""
"20.06.2024";"20.06.2024";"Nets 0147 8822884                   -SE MEDD.";"";"2.835,90";"280.219,10";""
"21.06.2024";"21.06.2024";"Nets 0148 8822884                   -SE MEDD.";"";"5.176,15";"285.395,25";""
"21.06.2024";"21.06.2024";"DK  3257668 108645139950 20.06";"";"6.902,80";"292.298,05";""
"21.06.2024";"21.06.2024";"Mealo: 20333                        -SE MEDD.";"";"28.303,11";"320.601,16";""
"24.06.2024";"24.06.2024";"Overførsel                          -SE MEDD.";"";"13.068,20";"333.669,36";""
"24.06.2024";"24.06.2024";"VD 00056 INCO CC GLOSTRUP A/S";"";"-3.685,80";"329.983,56";""
"24.06.2024";"24.06.2024";"DK  3257668 108645140150 21.06";"";"3.015,00";"332.998,56";""
"24.06.2024";"24.06.2024";"LS 46868 THAI FRESH IMPORT/EKSPORT";"";"-6.400,00";"326.598,56";""
"24.06.2024";"24.06.2024";"DK  3257668 108645140350 22.06";"";"6.279,00";"332.877,56";""
"24.06.2024";"24.06.2024";"DK  3257668 108645140550 23.06";"";"530,00";"333.407,56";""
"24.06.2024";"24.06.2024";"DK  3257668 417520800000 23.06";"";"1.031,00";"334.438,56";""
"24.06.2024";"24.06.2024";"VD 00057 INCO CC GLOSTRUP A/S";"";"-3.137,85";"331.300,71";""
"25.06.2024";"25.06.2024";"Nets 0149 8822884                   -SE MEDD.";"";"4.542,03";"335.842,74";""
"25.06.2024";"25.06.2024";"Nets 0150 8822884                   -SE MEDD.";"";"4.719,15";"340.561,89";""
"25.06.2024";"25.06.2024";"VD 00058 BAUHAUS ISHOEJ";"";"-809,55";"339.752,34";""
"25.06.2024";"25.06.2024";"VD 00059 LumLum Thai Street Kitche";"";"-1.352,00";"338.400,34";""
"26.06.2024";"26.06.2024";"BS VERISURE A/S";"";"-461,00";"337.939,34";""
"26.06.2024";"26.06.2024";"DK  3257668 108645140850 25.06";"";"921,00";"338.860,34";""
"26.06.2024";"26.06.2024";"DK  3257668 417720800000 25.06";"";"900,00";"339.760,34";""
"26.06.2024";"26.06.2024";"LS 46868 THAI FRESH IMPORT/EKSPORT";"";"-6.050,00";"333.710,34";""
"26.06.2024";"26.06.2024";"Nets 0151 8822884                   -SE MEDD.";"";"7.824,35";"341.534,69";""
"26.06.2024";"26.06.2024";"AB Tingstad Papper                  -SE MEDD.";"";"-5.453,00";"336.081,69";""
"26.06.2024";"26.06.2024";"VD 00060 COOP365 TAASTRUP";"";"-43,80";"336.037,89";""
"26.06.2024";"26.06.2024";"VD 00061 IKEA TAASTRUP HFB ECO";"";"-1.034,00";"335.003,89";""
"27.06.2024";"27.06.2024";"Fødevarestyrelsen 24077081Fakturanr";"";"-611,00";"334.392,89";""
"27.06.2024";"27.06.2024";"DK  3257668 108645141050 26.06";"";"2.150,00";"336.542,89";""
"27.06.2024";"27.06.2024";"Wolt Danmark DRIVE";"";"-3.475,00";"333.067,89";""
"27.06.2024";"27.06.2024";"Overførsel                          -SE MEDD.";"";"11.359,40";"344.427,29";""
"27.06.2024";"27.06.2024";"Nets 0152 8822884                   -SE MEDD.";"";"4.570,77";"348.998,06";""
"27.06.2024";"27.06.2024";"Løn";"";"-94.804,10";"254.193,96";""
"27.06.2024";"27.06.2024";"Overførsel";"";"-213,51";"253.980,45";""
"28.06.2024";"28.06.2024";"DK  3257668 108645141250 27.06";"";"3.102,00";"257.082,45";""
"28.06.2024";"28.06.2024";"DK  3257668 417920800000 27.06";"";"996,00";"258.078,45";""
"28.06.2024";"28.06.2024";"Nets 0153 8822884                   -SE MEDD.";"";"2.602,12";"260.680,57";""
"28.06.2024";"28.06.2024";"Fra Tania Damsgaard                 -SE MEDD.";"";"250,00";"260.930,57";""
"28.06.2024";"28.06.2024";"ATP";"";"-5.247,00";"255.683,57";""
"28.06.2024";"28.06.2024";"Mealo: 20629                        -SE MEDD.";"";"22.272,51";"277.956,08";""
"28.06.2024";"28.06.2024";"Omkostninger, Netbank og Mobilbank";"";"-1.089,50";"276.866,58";""
"28.06.2024";"28.06.2024";"Omkostninger, Netbank og Mobilbank";"";"-35,00";"276.831,58";""
"28.06.2024";"28.06.2024";"Omkostninger transaktioner";"";"-74,25";"276.757,33";""
"28.06.2024";"28.06.2024";"Grundbeløb, kvartalsafgift";"";"-400,00";"276.357,33";""
"28.06.2024";"28.06.2024";"35 Omkostninger overførselsservice";"";"-26,25";"276.331,08";""
"01.07.2024";"01.07.2024";"VD 00062 INCO CC GLOSTRUP A/S";"";"-3.747,56";"272.583,52";""
"01.07.2024";"01.07.2024";"VD 00063 COOP KVICKLY TAASTRUP";"";"-113,90";"272.469,62";""
"01.07.2024";"01.07.2024";"BS REMONDIS A/S";"";"-3.638,88";"268.830,74";""
"01.07.2024";"01.07.2024";"BS ATP - SAMLET BETALING";"";"-7.251,14";"261.579,60";""
"01.07.2024";"01.07.2024";"BS ONLINEPOS APS";"";"-2.061,25";"259.518,35";""
"01.07.2024";"01.07.2024";"BS NRGI ELHANDEL A/S";"";"-10.228,10";"249.290,25";""
"01.07.2024";"01.07.2024";"BS EJD. 643 TAASTRUP HOVEDGADE 64";"";"-36.389,19";"212.901,06";""
"01.07.2024";"01.07.2024";"DK  3257668 108645141450 28.06";"";"3.788,00";"216.689,06";""
"01.07.2024";"01.07.2024";"DK  3257668 418020800000 28.06";"";"1.119,00";"217.808,06";""
"01.07.2024";"01.07.2024";"LS 46868 THAI FRESH IMPORT/EKSPORT";"";"-6.877,50";"210.930,56";""
"01.07.2024";"01.07.2024";"DK  3257668 108645141650 29.06";"";"2.228,00";"213.158,56";""
"01.07.2024";"01.07.2024";"DK  3257668 108645141850 30.06";"";"2.919,00";"216.077,56";""
"01.07.2024";"01.07.2024";"DK  3257668 418120800000 29.06";"";"745,00";"216.822,56";""
"01.07.2024";"01.07.2024";"DK  3257668 418220800000 30.06";"";"521,00";"217.343,56";""
"02.07.2024";"02.07.2024";"Overførsel                          -SE MEDD.";"";"12.303,90";"229.647,46";""
"02.07.2024";"02.07.2024";"BS TELENOR A/S";"";"-441,19";"229.206,27";""
"02.07.2024";"02.07.2024";"Nets 0154 8822884                   -SE MEDD.";"";"4.727,27";"233.933,54";""
"02.07.2024";"02.07.2024";"Nets 0155 8822884                   -SE MEDD.";"";"3.711,61";"237.645,15";""
"03.07.2024";"03.07.2024";"PBS DK Abon 3257668 010624-300624";"";"-445,06";"237.200,09";""
"03.07.2024";"03.07.2024";"DK  3257668 108645142150 02.07";"";"3.218,00";"240.418,09";""
"03.07.2024";"03.07.2024";"Nets 0156 8822884                   -SE MEDD.";"";"5.829,10";"246.247,19";""
"03.07.2024";"03.07.2024";"VD 00064 INCO CC GLOSTRUP A/S";"";"-3.838,44";"242.408,75";""
"04.07.2024";"04.07.2024";"DK  3257668 108645142350 03.07";"";"2.208,00";"244.616,75";""
"04.07.2024";"04.07.2024";"LS 46868 THAI FRESH IMPORT/EKSPORT";"";"-5.667,50";"238.949,25";""
"04.07.2024";"04.07.2024";"Nets 0157 8822884                   -SE MEDD.";"";"2.715,86";"241.665,11";""
"04.07.2024";"04.07.2024";"VD 00065 Selfmade Roskilde";"";"-626,40";"241.038,71";""
"05.07.2024";"05.07.2024";"LS 21865 CARLSBERG DANMARK A/S";"";"-875,00";"240.163,71";""
"05.07.2024";"05.07.2024";"DK  3257668 108645142550 04.07";"";"4.302,00";"244.465,71";""
"05.07.2024";"05.07.2024";"DK  3257668 418620800000 04.07";"";"563,00";"245.028,71";""
"05.07.2024";"05.07.2024";"LS 44733 DERMAN PACK APS";"";"-2.753,73";"242.274,98";""
"05.07.2024";"05.07.2024";"LS 47422 DAKA DENMARK A/S";"";"-723,26";"241.551,72";""
"05.07.2024";"05.07.2024";"Nets 0158 8822884                   -SE MEDD.";"";"3.785,61";"245.337,33";""
"05.07.2024";"05.07.2024";"Mealo: 20737                        -SE MEDD.";"";"25.910,88";"271.248,21";""
"08.07.2024";"08.07.2024";"VD 00067 IKEA TAASTRUP HFB ECO";"";"-622,00";"270.626,21";""
"08.07.2024";"08.07.2024";"VD 00066 INCO CC GLOSTRUP A/S";"";"-4.142,39";"266.483,82";""
"08.07.2024";"08.07.2024";"DK  3257668 108645142750 05.07";"";"1.935,00";"268.418,82";""
"08.07.2024";"08.07.2024";"DK  3257668 418720800000 05.07";"";"160,00";"268.578,82";""
"08.07.2024";"08.07.2024";"LS 46868 THAI FRESH IMPORT/EKSPORT";"";"-3.946,25";"264.632,57";""
"08.07.2024";"08.07.2024";"DK  3257668 108645142950 06.07";"";"4.250,40";"268.882,97";""
"08.07.2024";"08.07.2024";"DK  3257668 108645143150 07.07";"";"2.334,00";"271.216,97";""
"08.07.2024";"08.07.2024";"DK  3257668 418820800000 06.07";"";"1.283,00";"272.499,97";""
"08.07.2024";"08.07.2024";"DK  3257668 418920800000 07.07";"";"600,00";"273.099,97";""
"08.07.2024";"08.07.2024";"VD 00069 INCO CC GLOSTRUP A/S";"";"-612,48";"272.487,49";""
"08.07.2024";"08.07.2024";"VD 00068 INCO CC GLOSTRUP A/S";"";"-2.737,04";"269.750,45";""
"09.07.2024";"09.07.2024";"Overførsel                          -SE MEDD.";"";"12.731,05";"282.481,50";""
"09.07.2024";"09.07.2024";"Nets 0159 8822884                   -SE MEDD.";"";"2.783,22";"285.264,72";""
"09.07.2024";"09.07.2024";"Nets 0160 8822884                   -SE MEDD.";"";"4.086,19";"289.350,91";""
"10.07.2024";"10.07.2024";"LS 21865 CARLSBERG DANMARK A/S";"";"-6.921,51";"282.429,40";""
"10.07.2024";"10.07.2024";"DK  3257668 108645143450 09.07";"";"2.322,00";"284.751,40";""
"10.07.2024";"10.07.2024";"DK  3257668 419120800000 09.07";"";"1.569,00";"286.320,40";""
"10.07.2024";"10.07.2024";"Nets 0161 8822884                   -SE MEDD.";"";"11.297,38";"297.617,78";""
"10.07.2024";"10.07.2024";"A-skat";"";"-43.049,00";"254.568,78";""
"10.07.2024";"10.07.2024";"VD 00070 INCO CC GLOSTRUP A/S";"";"-3.698,90";"250.869,88";""
"11.07.2024";"11.07.2024";"Afdrag lån Jarvinen";"";"-10.000,00";"240.869,88";""
"11.07.2024";"11.07.2024";"E-conomic";"";"-933,75";"239.936,13";""
"11.07.2024";"11.07.2024";"DK  3257668 108645143650 10.07";"";"2.521,30";"242.457,43";""
"11.07.2024";"11.07.2024";"DK  3257668 419220800000 10.07";"";"889,00";"243.346,43";""
"11.07.2024";"11.07.2024";"LS 46868 THAI FRESH IMPORT/EKSPORT";"";"-4.216,25";"239.130,18";""
"11.07.2024";"11.07.2024";"Nets 0162 8822884                   -SE MEDD.";"";"1.004,91";"240.135,09";""
"12.07.2024";"12.07.2024";"Brøndbyvester VVS";"";"-1.385,94";"238.749,15";""
"12.07.2024";"12.07.2024";"Taastrup Erhvervsforening";"";"-732,50";"238.016,65";""
"12.07.2024";"12.07.2024";"DK  3257668 108645143850 11.07";"";"3.276,00";"241.292,65";""
"12.07.2024";"12.07.2024";"DK  3257668 419320800000 11.07";"";"677,00";"241.969,65";""
"12.07.2024";"12.07.2024";"LS 46868 THAI FRESH IMPORT/EKSPORT";"";"-3.865,00";"238.104,65";""
"12.07.2024";"12.07.2024";"Overførsel                          -SE MEDD.";"";"13.384,55";"251.489,20";""
"12.07.2024";"12.07.2024";"Nets 0163 8822884                   -SE MEDD.";"";"3.418,90";"254.908,10";""
"12.07.2024";"12.07.2024";"Mealo: 20939                        -SE MEDD.";"";"26.532,86";"281.440,96";""
"12.07.2024";"12.07.2024";"Feriepenge";"";"-9.446,27";"271.994,69";""
"15.07.2024";"15.07.2024";"VD 00072 INCO CC GLOSTRUP A/S";"";"-3.339,81";"268.654,88";""
"15.07.2024";"15.07.2024";"DK  3257668 108645144050 12.07";"";"4.016,00";"272.670,88";""
"15.07.2024";"15.07.2024";"LS 41033 ESMILEY A/S";"";"-1.236,38";"271.434,50";""
"15.07.2024";"15.07.2024";"Kosan Gas";"";"-1.498,76";"269.935,74";""
"15.07.2024";"15.07.2024";"DK  3257668 108645144250 13.07";"";"3.639,00";"273.574,74";""
"15.07.2024";"15.07.2024";"DK  3257668 108645144450 14.07";"";"3.534,00";"277.108,74";""
"15.07.2024";"15.07.2024";"DK  3257668 419520800000 13.07";"";"2.287,00";"279.395,74";""
"15.07.2024";"15.07.2024";"DK  3257668 419620800000 14.07";"";"1.125,00";"280.520,74";""
"16.07.2024";"16.07.2024";"Nets 0164 8822884                   -SE MEDD.";"";"3.415,91";"283.936,65";""
"16.07.2024";"16.07.2024";"Nets 0165 8822884                   -SE MEDD.";"";"3.081,41";"287.018,06";""
"16.07.2024";"16.07.2024";"NETS terminalleje 149";"";"-1.046,25";"285.971,81";""
"16.07.2024";"16.07.2024";"Abak kloak 122780";"";"-1.383,75";"284.588,06";""
"17.07.2024";"17.07.2024";"Vision Watercare 10096007";"";"-838,00";"283.750,06";""
"17.07.2024";"17.07.2024";"DK  3257668 108645144750 16.07";"";"3.215,50";"286.965,56";""
"17.07.2024";"17.07.2024";"Nets 0166 8822884                   -SE MEDD.";"";"6.415,04";"293.380,60";""
"18.07.2024";"18.07.2024";"Gastropoint Kølerum 3529";"";"-48.125,00";"245.255,60";""
"18.07.2024";"18.07.2024";"Overførsel                          -SE MEDD.";"";"13.523,65";"258.779,25";""
"18.07.2024";"18.07.2024";"DK  3257668 108645144950 17.07";"";"2.853,00";"261.632,25";""
"18.07.2024";"18.07.2024";"DK  3257668 419920800000 17.07";"";"1.422,00";"263.054,25";""
"18.07.2024";"18.07.2024";"LS 46868 THAI FRESH IMPORT/EKSPORT";"";"-10.228,75";"252.825,50";""
"18.07.2024";"18.07.2024";"Nets 0167 8822884                   -SE MEDD.";"";"4.199,90";"257.025,40";""
"18.07.2024";"18.07.2024";"VD 00086 INCO CC GLOSTRUP A/S";"";"-4.568,69";"252.456,71";""
"19.07.2024";"19.07.2024";"DK  3257668 108645145150 18.07";"";"3.153,00";"255.609,71";""
"19.07.2024";"19.07.2024";"DK  3257668 420020800000 18.07";"";"1.191,00";"256.800,71";""
"19.07.2024";"19.07.2024";"LS 46868 THAI FRESH IMPORT/EKSPORT";"";"-4.242,50";"252.558,21";""
"19.07.2024";"19.07.2024";"Nets 0168 8822884                   -SE MEDD.";"";"1.614,60";"254.172,81";""
"19.07.2024";"19.07.2024";"Mealo: 21136                        -SE MEDD.";"";"26.124,01";"280.296,82";""
"22.07.2024";"22.07.2024";"1 Hastebestilling af kort";"";"-300,00";"279.996,82";""
"22.07.2024";"22.07.2024";"DK  3257668 108645145350 19.07";"";"2.396,00";"282.392,82";""
"22.07.2024";"22.07.2024";"DK  3257668 420120800000 19.07";"";"343,00";"282.735,82";""
"22.07.2024";"22.07.2024";"Til 6695 1004411923 Østfeldt Trad";"";"-3.400,00";"279.335,82";""
"22.07.2024";"22.07.2024";"DK  3257668 108645145550 20.07";"";"1.034,00";"280.369,82";""
"22.07.2024";"22.07.2024";"DK  3257668 108645145750 21.07";"";"365,00";"280.734,82";""
"22.07.2024";"22.07.2024";"DK  3257668 420220800000 20.07";"";"966,00";"281.700,82";""
"22.07.2024";"22.07.2024";"DK  3257668 420320800000 21.07";"";"422,00";"282.122,82";""
"22.07.2024";"22.07.2024";"VD 00001 INCO CC GLOSTRUP A/S";"";"-2.049,08";"280.073,74";""
"23.07.2024";"23.07.2024";"Overførsel                          -SE MEDD.";"";"17.135,20";"297.208,94";""
"23.07.2024";"23.07.2024";"Nets 0169 8822884                   -SE MEDD.";"";"3.256,11";"300.465,05";""
"23.07.2024";"23.07.2024";"Nets 0170 8822884                   -SE MEDD.";"";"4.917,48";"305.382,53";""
"23.07.2024";"23.07.2024";"VD 00002 CINCO KOBENHAVN APS";"";"-1.420,00";"303.962,53";""
"24.07.2024";"24.07.2024";"LS 21865 CARLSBERG DANMARK A/S";"";"-5.916,18";"298.046,35";""
"24.07.2024";"24.07.2024";"DK  3257668 108645146050 23.07";"";"2.066,00";"300.112,35";""
"24.07.2024";"24.07.2024";"Nets 0171 8822884                   -SE MEDD.";"";"7.069,09";"307.181,44";""
"25.07.2024";"25.07.2024";"DK  3257668 108645146250 24.07";"";"3.788,00";"310.969,44";""
"25.07.2024";"25.07.2024";"DK  3257668 420620800000 24.07";"";"278,00";"311.247,44";""
"25.07.2024";"25.07.2024";"LS 46868 THAI FRESH IMPORT/EKSPORT";"";"-4.456,50";"306.790,94";""
"25.07.2024";"25.07.2024";"Nets 0172 8822884                   -SE MEDD.";"";"2.887,06";"309.678,00";""
"26.07.2024";"26.07.2024";"LS 46868 THAI FRESH IMPORT/EKSPORT";"";"-10.082,00";"299.596,00";""
"26.07.2024";"26.07.2024";"Mealo: 21328                        -SE MEDD.";"";"24.587,17";"324.183,17";""
"26.07.2024";"26.07.2024";"Nets 0173 8822884                   -SE MEDD.";"";"2.390,89";"326.574,06";""
"29.07.2024";"29.07.2024";"Overførsel                          -SE MEDD.";"";"9.584,90";"336.158,96";""
"29.07.2024";"29.07.2024";"Wolt Danmark DRIVE";"";"-3.095,00";"333.063,96";""
"29.07.2024";"29.07.2024";"BS VERISURE A/S";"";"-461,00";"332.602,96";""
"30.07.2024";"30.07.2024";"Løn";"";"-90.412,40";"242.190,56";""
"30.07.2024";"30.07.2024";"Overførsel";"";"-213,51";"241.977,05";""
"31.07.2024";"31.07.2024";"Omkostninger, Netbank og Mobilbank";"";"-2,00";"241.975,05";""
"31.07.2024";"31.07.2024";"1 Visa Debit, årlig kortbetaling";"";"-150,00";"241.825,05";""
"31.07.2024";"31.07.2024";"Fra Tania Damsgaard                 -SE MEDD.";"";"250,00";"242.075,05";""
"01.08.2024";"01.08.2024";"BS REMONDIS A/S";"";"-3.454,69";"238.620,36";""
"01.08.2024";"01.08.2024";"BS ONLINEPOS APS";"";"-2.061,25";"236.559,11";""
"01.08.2024";"01.08.2024";"BS NRGI ELHANDEL A/S";"";"-10.453,78";"226.105,33";""
"01.08.2024";"01.08.2024";"BS EJD. 643 TAASTRUP HOVEDGADE 64";"";"-36.389,19";"189.716,14";""
"01.08.2024";"01.08.2024";"LS 46868 THAI FRESH IMPORT/EKSPORT";"";"-2.493,75";"187.222,39";""
"02.08.2024";"04.05.2024";"Visa Debit, årlig kortbetaling";"";"92,88";"187.315,27";""
"02.08.2024";"02.08.2024";"Mealo: 21526                        -SE MEDD.";"";"2.848,75";"190.164,02";""
"05.08.2024";"05.08.2024";"LS 47422 DAKA DENMARK A/S";"";"-679,43";"189.484,59";""
"05.08.2024";"05.08.2024";"Henri Lee";"";"-2.800,00";"186.684,59";""
"06.08.2024";"06.08.2024";"Henri Gordon Lee -1.378,62 EUR kurs: 748,360000";"";"-10.317,04";"176.367,55";""
"07.08.2024";"07.08.2024";"PBS DK Abon 3257668 010724-310724";"";"-315,90";"176.051,65";""
"07.08.2024";"07.08.2024";"DK  3257668 108645147650 06.08";"";"1.569,00";"177.620,65";""
"08.08.2024";"08.08.2024";"DK  3257668 108645147950 07.08";"";"5.993,00";"183.613,65";""
"08.08.2024";"08.08.2024";"Nets 0174 8822884                   -SE MEDD.";"";"3.664,82";"187.278,47";""
"09.08.2024";"09.08.2024";"DK  3257668 108645148150 08.08";"";"1.097,00";"188.375,47";""
"09.08.2024";"09.08.2024";"DK  3257668 422120800000 08.08";"";"1.311,00";"189.686,47";""
"09.08.2024";"09.08.2024";"Nets 0175 8822884                   -SE MEDD.";"";"5.815,35";"195.501,82";""
"09.08.2024";"09.08.2024";"Mealo: 21726                        -SE MEDD.";"";"2.729,65";"198.231,47";""
"12.08.2024";"12.08.2024";"Afdrag lån Jarvinen";"";"-10.000,00";"188.231,47";""
"12.08.2024";"12.08.2024";"DK  3257668 108645148350 09.08";"";"3.405,00";"191.636,47";""
"12.08.2024";"12.08.2024";"DK  3257668 422220800000 09.08";"";"1.677,00";"193.313,47";""
"12.08.2024";"12.08.2024";"DK  3257668 108645148550 10.08";"";"4.761,00";"198.074,47";""
"12.08.2024";"12.08.2024";"DK  3257668 108645148750 11.08";"";"970,00";"199.044,47";""
"12.08.2024";"12.08.2024";"DK  3257668 422320800000 10.08";"";"185,00";"199.229,47";""
"12.08.2024";"12.08.2024";"DK  3257668 422420800000 11.08";"";"1.639,00";"200.868,47";""
"12.08.2024";"12.08.2024";"A-skat";"";"-39.246,00";"161.622,47";""
"13.08.2024";"13.08.2024";"Overførsel                          -SE MEDD.";"";"14.853,70";"176.476,17";""
"13.08.2024";"13.08.2024";"Nets 0176 8822884                   -SE MEDD.";"";"5.430,00";"181.906,17";""
"13.08.2024";"13.08.2024";"Nets 0177 8822884                   -SE MEDD.";"";"3.692,69";"185.598,86";""
"14.08.2024";"14.08.2024";"DK  3257668 108645149050 13.08";"";"1.920,00";"187.518,86";""
"14.08.2024";"14.08.2024";"DK  3257668 422620800000 13.08";"";"861,00";"188.379,86";""
"14.08.2024";"14.08.2024";"Nets 0178 8822884                   -SE MEDD.";"";"6.402,01";"194.781,87";""
"14.08.2024";"14.08.2024";"Feriepenge";"";"-8.984,80";"185.797,07";""
"15.08.2024";"15.08.2024";"Kosan Gas";"";"-1.498,76";"184.298,31";""
"15.08.2024";"15.08.2024";"Securitas Dansk Brandteknik";"";"-1.040,78";"183.257,53";""
"15.08.2024";"15.08.2024";"DK  3257668 108645149250 14.08";"";"6.592,00";"189.849,53";""
"15.08.2024";"15.08.2024";"DK  3257668 422720800000 14.08";"";"348,00";"190.197,53";""
"15.08.2024";"15.08.2024";"LS 46868 THAI FRESH IMPORT/EKSPORT";"";"-11.126,00";"179.071,53";""
"15.08.2024";"15.08.2024";"Nets 0179 8822884                   -SE MEDD.";"";"675,24";"179.746,77";""
"15.08.2024";"15.08.2024";"VD 00003 INCO CC GLOSTRUP A/S";"";"-6.109,76";"173.637,01";""
"16.08.2024";"16.08.2024";"DK  3257668 108645149450 15.08";"";"2.225,00";"175.862,01";""
"16.08.2024";"16.08.2024";"DK  3257668 422820800000 15.08";"";"300,00";"176.162,01";""
"16.08.2024";"16.08.2024";"Nets 0180 8822884                   -SE MEDD.";"";"5.072,25";"181.234,26";""
"16.08.2024";"16.08.2024";"AB Tingstad Papper                  -SE MEDD.";"";"-6.140,00";"175.094,26";""
"16.08.2024";"16.08.2024";"Maxigastro 2204-MGRM";"";"-4.123,13";"170.971,13";""
"19.08.2024";"19.08.2024";"Overførsel                          -SE MEDD.";"";"12.488,55";"183.459,68";""
"19.08.2024";"19.08.2024";"Mealo: 21928                        -SE MEDD.";"";"25.114,77";"208.574,45";""
"19.08.2024";"19.08.2024";"DK  3257668 108645149650 16.08";"";"3.119,00";"211.693,45";""
"19.08.2024";"19.08.2024";"DK  3257668 422920800000 16.08";"";"1.003,00";"212.696,45";""
"19.08.2024";"19.08.2024";"LS 46868 THAI FRESH IMPORT/EKSPORT";"";"-9.244,50";"203.451,95";""
"19.08.2024";"19.08.2024";"DK  3257668 108645149850 17.08";"";"1.980,00";"205.431,95";""
"19.08.2024";"19.08.2024";"DK  3257668 108645150050 18.08";"";"2.154,00";"207.585,95";""
"19.08.2024";"19.08.2024";"DK  3257668 423020800000 17.08";"";"362,00";"207.947,95";""
"19.08.2024";"19.08.2024";"DK  3257668 423120800000 18.08";"";"551,00";"208.498,95";""
"19.08.2024";"19.08.2024";"Henri Lee - Inco 8/8";"";"-3.383,01";"205.115,94";""
"19.08.2024";"19.08.2024";"VD 00004 INCO CC GLOSTRUP A/S";"";"-2.443,19";"202.672,75";""
"20.08.2024";"20.08.2024";"Nets 0181 8822884                   -SE MEDD.";"";"1.718,40";"204.391,15";""
"20.08.2024";"20.08.2024";"Nets 0182 8822884                   -SE MEDD.";"";"3.828,65";"208.219,80";""
"21.08.2024";"21.08.2024";"DK  3257668 108645150350 20.08";"";"2.450,00";"210.669,80";""
"21.08.2024";"21.08.2024";"DK  3257668 423320800000 20.08";"";"529,00";"211.198,80";""
"21.08.2024";"21.08.2024";"Nets 0183 8822884                   -SE MEDD.";"";"9.711,49";"220.910,29";""
"22.08.2024";"22.08.2024";"DK  3257668 108645150550 21.08";"";"3.690,00";"224.600,29";""
"22.08.2024";"22.08.2024";"DK  3257668 423420800000 21.08";"";"1.011,00";"225.611,29";""
"22.08.2024";"22.08.2024";"Overførsel                          -SE MEDD.";"";"15.743,60";"241.354,89";""
"22.08.2024";"22.08.2024";"Nets 0184 8822884                   -SE MEDD.";"";"3.257,22";"244.612,11";""
"22.08.2024";"22.08.2024";"VD 00005 INCO CC GLOSTRUP A/S";"";"-2.034,23";"242.577,88";""
"23.08.2024";"23.08.2024";"DK  3257668 108645150750 22.08";"";"3.581,00";"246.158,88";""
"23.08.2024";"23.08.2024";"DK  3257668 423520800000 22.08";"";"712,00";"246.870,88";""
"23.08.2024";"23.08.2024";"LS 46868 THAI FRESH IMPORT/EKSPORT";"";"-7.972,75";"238.898,13";""
"23.08.2024";"23.08.2024";"Nets 0185 8822884                   -SE MEDD.";"";"3.613,54";"242.511,67";""
"23.08.2024";"23.08.2024";"Mealo: 22130                        -SE MEDD.";"";"26.042,03";"268.553,70";""
"23.08.2024";"23.08.2024";"VD 00006 Elgiganten Taastrup";"";"-7.299,01";"261.254,69";""
"26.08.2024";"26.08.2024";"VD 00007 INCO CC GLOSTRUP A/S";"";"-2.804,60";"258.450,09";""
"26.08.2024";"26.08.2024";"DK  3257668 108645150950 23.08";"";"5.555,00";"264.005,09";""
"26.08.2024";"26.08.2024";"DK  3257668 423620800000 23.08";"";"400,00";"264.405,09";""
"26.08.2024";"26.08.2024";"LS 44733 DERMAN PACK APS";"";"-3.195,00";"261.210,09";""
"26.08.2024";"26.08.2024";"LS 46868 THAI FRESH IMPORT/EKSPORT";"";"-10.560,25";"250.649,84";""
"26.08.2024";"26.08.2024";"DK  3257668 108645151150 24.08";"";"1.913,00";"252.562,84";""
"26.08.2024";"26.08.2024";"DK  3257668 108645151350 25.08";"";"3.411,00";"255.973,84";""
"27.08.2024";"27.08.2024";"Overførsel                          -SE MEDD.";"";"14.593,45";"270.567,29";""
"27.08.2024";"27.08.2024";"Nets 0186 8822884                   -SE MEDD.";"";"3.043,33";"273.610,62";""
"27.08.2024";"27.08.2024";"Nets 0187 8822884                   -SE MEDD.";"";"4.458,53";"278.069,15";""
"28.08.2024";"28.08.2024";"BS VERISURE A/S";"";"-461,00";"277.608,15";""
"28.08.2024";"28.08.2024";"DK  3257668 108645151650 27.08";"";"4.067,00";"281.675,15";""
"28.08.2024";"28.08.2024";"DK  3257668 424020800000 27.08";"";"632,00";"282.307,15";""
"28.08.2024";"28.08.2024";"Nets 0188 8822884                   -SE MEDD.";"";"5.619,39";"287.926,54";""
"29.08.2024";"29.08.2024";"Wolt Danmark DRIVE";"";"-1.717,50";"286.209,04";""
"29.08.2024";"29.08.2024";"LS 21865 CARLSBERG DANMARK A/S";"";"-37,50";"286.171,54";""
"29.08.2024";"29.08.2024";"DK  3257668 108645151850 28.08";"";"657,00";"286.828,54";""
"29.08.2024";"29.08.2024";"LS 46868 THAI FRESH IMPORT/EKSPORT";"";"-6.876,50";"279.952,04";""
"29.08.2024";"29.08.2024";"Nets 0189 8822884                   -SE MEDD.";"";"6.750,06";"286.702,10";""
"29.08.2024";"29.08.2024";"VD 00008 INCO CC GLOSTRUP A/S";"";"-2.914,70";"283.787,40";""
"29.08.2024";"29.08.2024";"Løn";"";"-78.532,40";"205.255,00";""
"29.08.2024";"29.08.2024";"Overførsel";"";"-240,10";"205.014,90";""
"30.08.2024";"30.08.2024";"Omkostninger, Netbank og Mobilbank";"";"-6,00";"205.008,90";""
"30.08.2024";"30.08.2024";"DK  3257668 108645152050 29.08";"";"1.628,00";"206.636,90";""
"30.08.2024";"30.08.2024";"DK  3257668 424220800000 29.08";"";"709,50";"207.346,40";""
"30.08.2024";"30.08.2024";"Fra Tania Damsgaard                 -SE MEDD.";"";"250,00";"207.596,40";""
"30.08.2024";"30.08.2024";"Nets 0190 8822884                   -SE MEDD.";"";"2.932,65";"210.529,05";""
"30.08.2024";"30.08.2024";"Mealo: 22335                        -SE MEDD.";"";"25.314,87";"235.843,92";""
"02.09.2024";"02.09.2024";"VD 00009 INCO CC GLOSTRUP A/S";"";"-4.091,83";"231.752,09";""
"02.09.2024";"02.09.2024";"Philipson Wine";"";"-2.649,50";"229.102,59";""
"02.09.2024";"02.09.2024";"BS REMONDIS A/S";"";"-4.492,84";"224.609,75";""
"02.09.2024";"02.09.2024";"BS TELENOR A/S";"";"-291,21";"224.318,54";""
"02.09.2024";"02.09.2024";"BS ONLINEPOS APS";"";"-2.061,25";"222.257,29";""
"02.09.2024";"02.09.2024";"BS NRGI ELHANDEL A/S";"";"-8.967,54";"213.289,75";""
"02.09.2024";"02.09.2024";"BS EJD. 643 TAASTRUP HOVEDGADE 64";"";"-36.389,19";"176.900,56";""
